xihsky	Russian
dvxrcsnbson	English
hqtaka	Russian
uwrnhosison	English
nkiegykdson	English
lltwa	Japanese
ordmcrjuka	Russian
gwcbvhyano	Italian
dmioev	Russian
lgviwson	English
frxhfomiakis	Greek
kyybhbzkton	English
gswano	Italian
pmuoeiehley	English
xsnsmas	Greek
qpcyson	English
ufzvin	Russian
mmtopoulos	Greek
ravxdakis	Greek
kdjnfoaxano	Italian
qdujakis	Greek
elyfakis	Greek
tkpos	Greek
zjhbhka	Russian
xpcka	Russian
vprfer	English
ngryxwgas	Greek
uloqodhhyama	Japanese
srhucci	Italian
cwuson	English
bkcley	English
vpgreley	English
hzpzngos	Greek
nlnnoxbvov	Russian
xkzdhgsky	Russian
enfiohos	Greek
dburacyto	Japanese
ppgmbfton	English
izzojnka	Russian
gjgbko	Japanese
xkbos	Greek
qqfbqcis	Greek
cvhmdshka	Russian
tcnakis	Greek
kigvwkhas	Greek
vujowa	Japanese
otsov	Russian
gqielchev	Russian
orwjucci	Italian
vrjos	Greek
ddxreer	English
gwkgvuiucci	Italian
bcuniyama	Japanese
yeuifin	Russian
nradcweros	Greek
renebjlini	Italian
vhvdano	Italian
txehfzis	Greek
fxkki	Japanese
fzwdmson	English
goljto	Japanese
vgmer	English
yilucci	Italian
rkadifsiyama	Japanese
nlxzkntka	Russian
sgibwnov	Russian
vxxxvglopoulos	Greek
ktkvdxjqev	Russian
mwjreto	Japanese
mvxftsjmko	Japanese
jgnzska	Russian
oovgqpelli	Italian
qvutkov	Russian
jhzgeabhton	English
onuakis	Greek
wmpmheuwson	English
hfzwqoov	Russian
doezopoulos	Greek
tkyotxqopoulos	Greek
fxpoiyis	Greek
puhiocwano	Italian
kkrceman	English
wewgcnton	English
onbgnmyucci	Italian
mpaljymin	Russian
xrzthphiopoulos	Greek
mkvki	Japanese
etramsley	English
unein	Russian
imkman	English
kymiyki	Japanese
paxucci	Italian
hucyuov	Russian
gatesky	Russian
vdsgower	English
ttxwini	Italian
dsajston	English
gcswuhdwwa	Japanese
zszos	Greek
nvlcqukini	Italian
dnluowto	Japanese
xquiko	Japanese
onxsikis	Greek
ohyoska	Russian
apkfpto	Japanese
kitwiucci	Italian
gchxnprsky	Russian
wpozacjhki	Japanese
vslprley	English
xrklwoano	Italian
hdxgkini	Italian
fggxpixsakis	Greek
dgjhlis	Greek
wreano	Italian
rjwsky	Russian
asjki	Japanese
kfbipdyama	Japanese
csuvbeto	Japanese
chdryopoulos	Greek
zthyqmoopoulos	Greek
njstbtxini	Italian
givcfhfrson	English
nowley	English
bhjwjki	Japanese
hizzusvzsky	Russian
rhuto	Japanese
cbfzano	Italian
sjodowjwopoulos	Greek
rpoctbnano	Italian
achvsakis	Greek
isbyyfpqin	Russian
snupini	Italian
nkkvdto	Japanese
wpjvmyucci	Italian
ckikdyin	Russian
vroopoulos	Greek
qltyin	Russian
girto	Japanese
wpdautelli	Italian
rarncman	English
duepwjka	Russian
pphorerio	Italian
qxeciyzton	English
iajxjssrio	Italian
rplkryley	English
kgwhsmto	Japanese
kxpki	Japanese
zuepbeqswa	Japanese
dqoaxein	Russian
pzier	English
muckvrmkopoulos	Greek
tchas	Greek
cndyuwdoman	English
bkzini	Italian
lnehqrio	Italian
zfffctmtis	Greek
ehouioiyama	Japanese
vrfcowa	Japanese
unwioas	Greek
pdhmslley	English
javmiasvini	Italian
pjyzhtzlis	Greek
ivyxyvvman	English
ubjzobslsky	Russian
kxnfgsky	Russian
qqifiopoulos	Greek
kzdoceyhrio	Italian
czmaiakis	Greek
lvxvisin	Russian
vhpini	Italian
kthucuoas	Greek
ebbwa	Japanese
dhrto	Japanese
lvxwrnko	Japanese
udptnison	English
oohlini	Italian
ulbmigdrio	Italian
guutabzksky	Russian
gcyrgsgman	English
ztaielli	Italian
izfdvaeson	English
skafano	Italian
xnqdov	Russian
ylqsdoko	Japanese
bxzvqjoson	English
mnvdpwin	Russian
kteov	Russian
tusrwer	English
qjoqtndyama	Japanese
gnohnkomopoulos	Greek
nkvilsky	Russian
cccki	Japanese
xlzerbsrka	Russian
dnlvynxbano	Italian
ldsqgis	Greek
dlrlyama	Japanese
hznryttucci	Italian
vwiafiwev	Russian
afesvrio	Italian
xuacka	Russian
nokfljer	English
cbefytbos	Greek
vnptonano	Italian
dlndjvvley	English
vjbhmtbyama	Japanese
gyeyier	English
apxrio	Italian
mrwhley	English
zlcmxbnaopoulos	Greek
snsmwin	Russian
makelli	Italian
wlcndhopoulos	Greek
qcmjxkis	Greek
cquducci	Italian
yllxis	Greek
eigman	English
yyucis	Greek
ysysovko	Japanese
ukeocopoulos	Greek
jzisblqcwa	Japanese
bbljcuyama	Japanese
qmosrzxos	Greek
ugktpqeyama	Japanese
zkwyama	Japanese
fbhwooqqakis	Greek
ljmnyer	English
zuuas	Greek
drvmjev	Russian
kcsvis	Greek
uwvmeucci	Italian
rmuzksky	Russian
uvnakis	Greek
ljfelli	Italian
gheecjini	Italian
xqbvkytis	Greek
effwytis	Greek
nlvto	Japanese
jyxzohrto	Japanese
glvsooano	Italian
qnfgztewa	Japanese
plrdwqdjov	Russian
oqencman	English
anbmqwa	Japanese
clhakder	English
bjpwman	English
tacaigto	Japanese
tqndyjhjos	Greek
nuztin	Russian
ptrov	Russian
hwejnatas	Greek
nfvvcqlson	English
qzqrampos	Greek
ixalzyama	Japanese
xvuducci	Italian
blrkelli	Italian
pufzecwyki	Japanese
gbzgbev	Russian
mrpibyuelli	Italian
ybukiini	Italian
mxomkfrio	Italian
zqizcki	Japanese
tfrjkdov	Russian
jjotwnfwrio	Italian
bxltniini	Italian
umlqzxvfov	Russian
vzobecher	English
sbtevoano	Italian
ycseqlrio	Italian
ihdaxfpqrio	Italian
iyiopoulos	Greek
jwpgdecton	English
oczvkvlwson	English
jjfwwwuis	Greek
hdgzehzrio	Italian
rslozka	Russian
ccjmwxpley	English
scekucki	Japanese
qleyrusfto	Japanese
bdqejffwa	Japanese
qjcigley	English
ujtrini	Italian
fssefvtxakis	Greek
bacbuysano	Italian
ntuapurer	English
hzzvmjrio	Italian
bfonpogkka	Russian
wkxlmman	English
rdkhodirio	Italian
dbjmley	English
fksxwa	Japanese
pqoper	English
cmqki	Japanese
slbber	English
uvpjradki	Japanese
xlymlson	English
srgwa	Japanese
cmqoyakis	Greek
vtdedmlano	Italian
yegtqopoulos	Greek
bbeas	Greek
oetqektwa	Japanese
txjskqley	English
wsjpalas	Greek
sjzxwuov	Russian
iuzyssis	Greek
pfquxtyin	Russian
hbswdgaoer	English
nwgnko	Japanese
xxbweqis	Greek
vpqmkis	Greek
krlvyxvwa	Japanese
ghirjhas	Greek
gwwpkplrano	Italian
svrrio	Italian
yzejbwa	Japanese
ouixpsky	Russian
irwiedtley	English
bvqhman	English
nkwin	Russian
yearfnupin	Russian
kjubyson	English
rxxbis	Greek
bmzpto	Japanese
ajsucci	Italian
jourqin	Russian
oigzdkfton	English
faxkzjsvelli	Italian
umnqkcmson	English
pkhaer	English
oyikwa	Japanese
saiulwhbos	Greek
fmvqwwa	Japanese
jlthhepein	Russian
nwrpyakis	Greek
vytzson	English
qwlcsdos	Greek
gsrefkqopoulos	Greek
gwspcqozov	Russian
qnosyama	Japanese
vzjxamas	Greek
gscbnlwcka	Russian
pbjin	Russian
yuxuton	English
ommcvvucci	Italian
ldfrmqexman	English
jovka	Russian
mhholeito	Japanese
zvnka	Russian
gcdtov	Russian
vwbhxbmki	Japanese
gyybeqjman	English
styvkis	Greek
vqhnano	Italian
rsxelli	Italian
pbluvmzko	Japanese
nnejmfyrrio	Italian
jwezton	English
nnrqemhev	Russian
ucolcley	English
imvley	English
cgzakis	Greek
pgkjos	Greek
xdxyton	English
twgmhrkyer	English
ruljilko	Japanese
dzxpykto	Japanese
nbshxelli	Italian
rssxnev	Russian
khmsman	English
uvkiypxki	Japanese
xzlfto	Japanese
frubqbos	Greek
neusky	Russian
eagqolbtka	Russian
paarrnaako	Japanese
jaqwvnzelli	Italian
qehsky	Russian
ilizmclopoulos	Greek
hwhjvcuyama	Japanese
mmrpbuov	Russian
pnuer	English
qbhis	Greek
ibcvirakis	Greek
kagssky	Russian
jfsto	Japanese
vrkmyxis	Greek
xlbdnhcev	Russian
tmykauiopoulos	Greek
lrmnto	Japanese
mcytjzhwos	Greek
emwzusky	Russian
ldcajki	Japanese
decfnrio	Italian
qndaclros	Greek
zkmajnmos	Greek
sqfvopoulos	Greek
ijipman	English
ninjin	Russian
ihxupka	Russian
odejos	Greek
tmzkowa	Japanese
tejktwgpwa	Japanese
kjxwupley	English
mizmlson	English
srfvakis	Greek
owgozjwcin	Russian
ujhito	Japanese
cotpsmko	Japanese
nrbzlwzrakis	Greek
yhvev	Russian
tbsuvumyer	English
adito	Japanese
qrswsholopoulos	Greek
swqelapdwa	Japanese
dxewa	Japanese
ozgqpano	Italian
oxwki	Japanese
jbzini	Italian
udvzfsky	Russian
rfkropoulos	Greek
zmufto	Japanese
axtgoski	Japanese
wggwa	Japanese
dzrflkgin	Russian
vpqukka	Russian
msdllotto	Japanese
scvekdhano	Italian
lweqin	Russian
esmnfpuko	Japanese
fpjefkoley	English
apegmka	Russian
pnvpnwopis	Greek
azyhjbisky	Russian
fyosxopoulos	Greek
dsdiyrlakis	Greek
orgndxuysky	Russian
oilini	Italian
yzhto	Japanese
lwtunfteis	Greek
slrer	English
fkwjjsiakis	Greek
yznbev	Russian
ehewkhyvton	English
suiuki	Japanese
cuzycmko	Japanese
lopksayxini	Italian
vwlczrmgki	Japanese
ikjkrsman	English
zkvybbos	Greek
dfoki	Japanese
gweujfev	Russian
liclvufbin	Russian
wyhnucwdini	Italian
ceshqvton	English
wkdin	Russian
chmcxzson	English
ljemysky	Russian
qsaley	English
lxguxeton	English
ogcdeydsopoulos	Greek
kzehiuini	Italian
ttxtjywson	English
qtqgrio	Italian
bzzhpmdhrio	Italian
qalas	Greek
snlrvfton	English
scaev	Russian
bzmley	English
wqynnwmcucci	Italian
eicjcqgis	Greek
msuyuos	Greek
nxhbhcndrio	Italian
bjvxvxfos	Greek
ewafplqqev	Russian
exyixson	English
zniqcev	Russian
cpoqlbpsis	Greek
iydsini	Italian
qabahbplton	English
brzwton	English
hnxkison	English
dqvbfis	Greek
mcoas	Greek
croalelli	Italian
zjxtholucci	Italian
xryzto	Japanese
nahley	English
wakayvmxano	Italian
qhnpov	Russian
icbhqnwlton	English
dqeumcska	Russian
vehjikin	Russian
oihcgelli	Italian
edfopoulos	Greek
ndrlyto	Japanese
oidcfwa	Japanese
gkeos	Greek
mqbvjer	English
morley	English
odzman	English
byhsky	Russian
lvuucsley	English
acgrio	Italian
zkdson	English
fsnki	Japanese
mvnto	Japanese
fiioelli	Italian
tthujpnka	Russian
cimto	Japanese
uzqhko	Japanese
zwlprzin	Russian
qkmifakucci	Italian
zyison	English
lyshfdhto	Japanese
zxbyhszrio	Italian
fhskano	Italian
wwlakis	Greek
sgzpakis	Greek
pbcbelli	Italian
aqpaas	Greek
zekwis	Greek
aeselli	Italian
lclwvmsov	Russian
kefxnrio	Italian
wrwtano	Italian
sfmjxwjeman	English
smysbftkka	Russian
sdpekxcher	English
ucwvano	Italian
ighyama	Japanese
zdxabrio	Italian
nfnpmlrmyama	Japanese
uyvhfocyama	Japanese
kidini	Italian
mfxcucci	Italian
ttpwain	Russian
nfbdkggton	English
xrivjjhdos	Greek
rpeblanyama	Japanese
utpgdagfano	Italian
djzmppev	Russian
rmflmlfoov	Russian
oihisbelli	Italian
vlzka	Russian
hrbmqnrki	Japanese
pjcmos	Greek
qzsvtedopoulos	Greek
gzgeson	English
vngto	Japanese
kxzccopoulos	Greek
rkiqoaakis	Greek
zndneesakis	Greek
dsyos	Greek
lnimupsucci	Italian
fimto	Japanese
vwmbmkwis	Greek
pilakzjjev	Russian
vdhejxoywa	Japanese
ntucgognrio	Italian
bqzfcas	Greek
eyqsafis	Greek
hboson	English
giloqmudini	Italian
ptofpley	English
lfixwos	Greek
mbfucci	Italian
uhvger	English
ayyvapeto	Japanese
hitas	Greek
mloigoano	Italian
msdaqvlakis	Greek
jjvdpckas	Greek
iuwujelli	Italian
yhbzzztton	English
exaupjinrio	Italian
bswsgkxwto	Japanese
zpvlqjfvakis	Greek
dpexiley	English
kuchlhxjton	English
isjodrio	Italian
sstcpgqdin	Russian
nbeegas	Greek
oekwfycki	Japanese
fkubaoigelli	Italian
pzyyos	Greek
nunmnpmson	English
gxlakyqsky	Russian
auxhhwljsky	Russian
qsjfcbev	Russian
xqtqknelli	Italian
lygfzmini	Italian
xegxson	English
fdlwuzbopoulos	Greek
tbtbvduini	Italian
dnomdripsky	Russian
vuajnvdvley	English
twendqxucci	Italian
dzdpgka	Russian
qglwner	English
rpgton	English
aavcini	Italian
pecyqcxxos	Greek
hojiobdfini	Italian
zvknxini	Italian
aevsky	Russian
otixcano	Italian
dmmoano	Italian
pznuzfdeyama	Japanese
nspley	English
tmylko	Japanese
xeppdnobov	Russian
kawvqyxsucci	Italian
kqqwwtdnman	English
vvumeko	Japanese
aufakis	Greek
fcypkhwa	Japanese
qhrrio	Italian
coozko	Japanese
pokyama	Japanese
uadmnbrryama	Japanese
tujqrguin	Russian
bhokrucci	Italian
wvlwodos	Greek
kluer	English
lwdbfpeopoulos	Greek
tggdmsky	Russian
wkdyki	Japanese
vsdyoovska	Russian
aqxbrnley	English
yfwsfxeyama	Japanese
ttkqmntwto	Japanese
kjozeerio	Italian
xqjwrkwxakis	Greek
gtwjer	English
ufqrwukwson	English
pssvwnvucci	Italian
zaqdamelli	Italian
bgiyzfjvev	Russian
wzjman	English
lodakis	Greek
xurmis	Greek
jwvbmmnzas	Greek
axiis	Greek
huwwulakis	Greek
tgyxgjofos	Greek
xqdmson	English
riefswa	Japanese
owebeev	Russian
yutas	Greek
rlczwkqto	Japanese
czqfnrrton	English
hgvkkev	Russian
ytqpucci	Italian
vlosky	Russian
hbvkmzdopoulos	Greek
xjaqylqucci	Italian
bjugkqyama	Japanese
yrraov	Russian
uygvndgrton	English
veaowkbcov	Russian
zircka	Russian
nmoumton	English
mvducci	Italian
xtcyxsbwov	Russian
djzvjtcano	Italian
mvapfrto	Japanese
mzzrjuejer	English
redbastin	Russian
cjgxxxlis	Greek
qeffhtigyama	Japanese
zsbyrourson	English
cidgxspkano	Italian
uhdjtcgkton	English
tvjwsto	Japanese
lzknfakis	Greek
xunilevxer	English
olyjpryama	Japanese
tciergixson	English
quaka	Russian
ysgbriakis	Greek
uyelmhakis	Greek
oqqcrio	Italian
avhztvfucci	Italian
ffssveton	English
hypelli	Italian
lhbvgka	Russian
pobbukini	Italian
ixisrsfmopoulos	Greek
ucqimhqrio	Italian
pzptaucci	Italian
fhcquiman	English
fltwson	English
zkxdpvton	English
sfunyama	Japanese
essman	English
qbsebfifley	English
suaxxvjyama	Japanese
tppfhnley	English
yftvqifer	English
schmmedyama	Japanese
qvnetdfton	English
bzrqydcopoulos	Greek
rayvunqton	English
wqnelli	Italian
lszxywko	Japanese
eipyhcev	Russian
nigawxzos	Greek
dqamugwas	Greek
denuswa	Japanese
nsltivmelli	Italian
zrpflrrki	Japanese
slywmelli	Italian
hozwfdgqin	Russian
twvwbfmini	Italian
ptncov	Russian
lctbrio	Italian
uqjwtbyto	Japanese
agvzqjto	Japanese
qqwhtfvov	Russian
uafcano	Italian
vmmsgko	Japanese
wccrjxrsev	Russian
htgomucci	Italian
fnqdrov	Russian
kdzqiakis	Greek
womspis	Greek
vosapdano	Italian
uzhvwhev	Russian
qrawito	Japanese
mvxano	Italian
fpklgsisky	Russian
xghxhiman	English
htleson	English
vvpka	Russian
bpltkpsev	Russian
yqimto	Japanese
bqznopoulos	Greek
qlmis	Greek
wqowa	Japanese
vgmka	Russian
ltifrev	Russian
ptklfton	English
nwylwa	Japanese
ofsesto	Japanese
izhrnmgesky	Russian
fnpto	Japanese
xkzpjirakis	Greek
dwfbgiin	Russian
xkillrka	Russian
andlvucci	Italian
suurfyjer	English
qpyxocmtano	Italian
efuzknutko	Japanese
cfkto	Japanese
ujwitrio	Italian
ylxsqorio	Italian
aexher	English
fmddov	Russian
baymqycyama	Japanese
ecumjhhano	Italian
eeqfabvlwa	Japanese
riroewko	Japanese
touxusnley	English
lprhzos	Greek
lniejyama	Japanese
yeljprain	Russian
aynzjko	Japanese
rlgton	English
mhfwxuopoulos	Greek
icnuto	Japanese
zwvijuxakis	Greek
gcfejdrio	Italian
iwtpgkos	Greek
rafson	English
ewoxaelli	Italian
apgkin	Russian
lowzbkini	Italian
iymson	English
fgimadis	Greek
hxbgoxyama	Japanese
gpmvjkfuos	Greek
dipujglos	Greek
huner	English
zisdin	Russian
bszton	English
lychis	Greek
vtkyama	Japanese
uewrzov	Russian
hkrzuyer	English
gawmlxeiyama	Japanese
orjrwpgsto	Japanese
kxoitakis	Greek
qeoer	English
loayuqmelli	Italian
lythkxcka	Russian
qvpyko	Japanese
jknukddley	English
efbsky	Russian
gdbsumin	Russian
wsiblhtos	Greek
upcoov	Russian
xnlzwbtano	Italian
xcjos	Greek
ddxhrmgman	English
hsufrxrnos	Greek
vowvnos	Greek
rmqkman	English
olkrklnopoulos	Greek
hsrgmyrano	Italian
omaxbjucci	Italian
ejajhgkov	Russian
qrssedbrio	Italian
eilselli	Italian
zjcsmley	English
cxkzpfpwley	English
ujbxzsmov	Russian
lnndysky	Russian
uyuopoulos	Greek
qbkrssky	Russian
whebvxmrio	Italian
qchnjzmis	Greek
cpsxbley	English
cmqnyto	Japanese
rgpmusman	English
xqhhciyopoulos	Greek
scdvnnllelli	Italian
tuayjelli	Italian
zoteobhelli	Italian
yxcdini	Italian
ejakwzder	English
akgxrgto	Japanese
yirptxeos	Greek
vqbifbjto	Japanese
bouacopoulos	Greek
vldajumhrio	Italian
dkptrcfgakis	Greek
wabhqjkki	Japanese
falvllujto	Japanese
zbuimos	Greek
hekmvis	Greek
mqvtuvhnsky	Russian
njtkopoulos	Greek
guesakis	Greek
jwwqman	English
usfkyama	Japanese
xdfkexaas	Greek
joxuxito	Japanese
efaley	English
tsthtis	Greek
alcwypeqley	English
ulfmppefto	Japanese
nyaer	English
xvgyto	Japanese
otpwev	Russian
nmybko	Japanese
kmtxstrqyama	Japanese
oobis	Greek
mxbrmqyos	Greek
omjyjton	English
jtbwqeton	English
xqdto	Japanese
remnkoafopoulos	Greek
gocikwuwis	Greek
dwoev	Russian
wmxzqtfin	Russian
byfksvis	Greek
fywbton	English
xyojuelli	Italian
gatyev	Russian
pprzatin	Russian
svpoton	English
ttato	Japanese
turgbis	Greek
ulbman	English
stjkcbdnsky	Russian
jtvwwtszley	English
xslbcyer	English
mcynrini	Italian
edwikqrio	Italian
wgtbos	Greek
uqcpxwtzas	Greek
kiqstleko	Japanese
qxuppzis	Greek
wjgaos	Greek
uzdxgzka	Russian
bklrzuto	Japanese
gwjizcjjka	Russian
yadvkas	Greek
stafgkkvki	Japanese
uepto	Japanese
koznxbqwa	Japanese
vkrragsvas	Greek
eiaano	Italian
rfstmftdwa	Japanese
bincphloano	Italian
jfdlzbyman	English
qazpqesky	Russian
xqjykeini	Italian
egxbomwqos	Greek
bvtckin	Russian
qyvev	Russian
yjugkggev	Russian
kyovdieelli	Italian
atrucci	Italian
rlrkev	Russian
zjshfcjter	English
beapvbos	Greek
cnmto	Japanese
uwwotljas	Greek
yvzrcyyoley	English
zwoson	English
vuwyoki	Japanese
etilton	English
vkzkopacton	English
pofjyev	Russian
eqdmwzdas	Greek
czjromsnis	Greek
rfpmos	Greek
wsnzrio	Italian
rwhfvos	Greek
dstokros	Greek
jmctyama	Japanese
kpuvbcis	Greek
yuzayevman	English
jmtsoggwa	Japanese
zvjnwlcucci	Italian
qmejblrov	Russian
rldjahnwka	Russian
kwmmmnrgto	Japanese
grmlki	Japanese
veeacson	English
pvneceuzton	English
tntfoqnrki	Japanese
hfntako	Japanese
hwqinrslyama	Japanese
pwldspwov	Russian
xqyyioqcley	English
hpuos	Greek
jtbkryaopoulos	Greek
psxknlzwa	Japanese
bwtxano	Italian
bupsfakis	Greek
jzxtajpcsky	Russian
ziiis	Greek
iiaxdakis	Greek
xevolzfer	English
fzqbkcman	English
pynyopoulos	Greek
oxufgsxlson	English
bforio	Italian
pxyrhki	Japanese
ieqnajki	Japanese
kqvbdrulki	Japanese
ikiizdiuakis	Greek
yvxhxvko	Japanese
kvwfkrason	English
ndqov	Russian
hxjigyama	Japanese
cbtvgtuov	Russian
temka	Russian
wfier	English
cuoiynwvwa	Japanese
yciyini	Italian
kbiifoyama	Japanese
tmfuki	Japanese
ryngka	Russian
widbccka	Russian
apeuuaini	Italian
ewkmsyama	Japanese
yppnmxyzos	Greek
amwyopoulos	Greek
rlkvjmbov	Russian
kcoyyjuelli	Italian
bmvgjwmson	English
cuoxgeini	Italian
xshton	English
zruwa	Japanese
zoabkbkyama	Japanese
gzuko	Japanese
rexshcbxto	Japanese
aptbhwueyama	Japanese
bjzdotfsson	English
ptzka	Russian
zgner	English
dvsrewa	Japanese
sfkson	English
eynfwev	Russian
ohsbis	Greek
tmyfapcaov	Russian
wuser	English
zzypwegewa	Japanese
nhftwbakis	Greek
ptcuzjlnson	English
gdqdakis	Greek
qhoyuvgano	Italian
dzevin	Russian
fvbbwa	Japanese
niktrio	Italian
xbrsky	Russian
pqdson	English
osskngxver	English
khdman	English
mhcpko	Japanese
negko	Japanese
mleoto	Japanese
gkebwucci	Italian
edoonsky	Russian
jtfzucci	Italian
rhcnqpgley	English
iaxnxhto	Japanese
shsesario	Italian
pxyka	Russian
qmpzzwov	Russian
hcryawki	Japanese
ljhuson	English
vjfwoska	Russian
oyewmfev	Russian
uaucmwkqyama	Japanese
yiwtrselli	Italian
kxbqvlbov	Russian
otbllto	Japanese
crwygekhakis	Greek
pxyswgyxsky	Russian
iqvniini	Italian
lopqqov	Russian
rvrjotlzyama	Japanese
ccmfjcson	English
dwepeman	English
ajnvreplopoulos	Greek
uajgcazhko	Japanese
skuuzkrio	Italian
wqroojseas	Greek
hpljyson	English
joftfley	English
fwwvelli	Italian
dbksman	English
lfgrwyama	Japanese
elorfucci	Italian
ampelli	Italian
eaxrqwa	Japanese
jysvezucci	Italian
wdxpbto	Japanese
jamakis	Greek
lckbtuman	English
hzyigacakis	Greek
vcqmgpktko	Japanese
vlmis	Greek
mlajlwa	Japanese
rcgxoxrio	Italian
fzxnxki	Japanese
tcegjpqer	English
ymcanuiin	Russian
owsyegfton	English
pbjsjprrio	Italian
zaeer	English
upduvjnfrio	Italian
dyiton	English
xlspsniin	Russian
qxsaisky	Russian
ekois	Greek
bilnano	Italian
jqucqsky	Russian
tyfley	English
vzjivano	Italian
sleaeqjev	Russian
kfdgeqto	Japanese
twqrwrwson	English
cdeaplwa	Japanese
otqyano	Italian
jaxdheweman	English
gecnini	Italian
ypyin	Russian
dbzvka	Russian
pdios	Greek
vaydzov	Russian
sgfvas	Greek
exika	Russian
fqyxtelli	Italian
cdsyaqgis	Greek
yraxini	Italian
wplwsfoson	English
mngqhton	English
dodqein	Russian
jrxbckpdrio	Italian
txjvohucci	Italian
ngczpwa	Japanese
vpvson	English
qvvcdeki	Japanese
sdxfclgkto	Japanese
dhnxpiakis	Greek
yzzumas	Greek
tmpqieyoyama	Japanese
pphueov	Russian
bcpvafmtev	Russian
ttdycley	English
gjvppqwa	Japanese
zrrayos	Greek
mokki	Japanese
bbfrvywa	Japanese
nejwmpson	English
pvrvrsppakis	Greek
bmipsmter	English
basbeano	Italian
sayukmdnano	Italian
lbvhhhano	Italian
wcjos	Greek
arkbrio	Italian
qniawpsyama	Japanese
smksdzrio	Italian
vgkpqzyvev	Russian
jlngpuzson	English
jibjakis	Greek
txcwko	Japanese
kicszqpin	Russian
zcujqer	English
rkgnmitqki	Japanese
auwqis	Greek
gvxoiuakis	Greek
sxubqgas	Greek
hexvwa	Japanese
kcugniwa	Japanese
vthmhson	English
ahzjton	English
nnubgfito	Japanese
zzivrsky	Russian
pzabcktjov	Russian
vvcmxto	Japanese
sxqson	English
syqipchtos	Greek
sxmzxelli	Italian
edfgwa	Japanese
isbprlyama	Japanese
npvhizeano	Italian
ljautbxvyama	Japanese
rmjuwer	English
homamijov	Russian
gfoukton	English
cyppxin	Russian
ndfwiqclrio	Italian
rxkowaybis	Greek
eamgujksyama	Japanese
hqwysky	Russian
nzkopxeiis	Greek
zjgcnas	Greek
mshaarley	English
ogiman	English
tntiecev	Russian
dawqnyoton	English
wggzev	Russian
pmengtgjelli	Italian
nzeawa	Japanese
tohlucci	Italian
apewa	Japanese
gwmwnxtiyama	Japanese
bbkhpltka	Russian
iqtin	Russian
vlerbselli	Italian
qpkoelli	Italian
wqneiov	Russian
epiano	Italian
ityiqwa	Japanese
kxpyto	Japanese
uzobgebhis	Greek
ifwondin	Russian
lwrpopov	Russian
lcger	English
xqisley	English
aqysfncman	English
dkajvvdmwa	Japanese
keaos	Greek
vpouitvawa	Japanese
tokxxzsesky	Russian
jkzbxcrtin	Russian
ifhymcov	Russian
mymjman	English
pznxzev	Russian
lvdlakis	Greek
ompistton	English
zltfnuin	Russian
qkosky	Russian
quuqcjton	English
zpjto	Japanese
jhqnjsbrson	English
dqnndovka	Russian
iscyqini	Italian
vofzfmbcin	Russian
sxoyvrio	Italian
kzfgfos	Greek
vdnraos	Greek
afuki	Japanese
mvxtxpjtko	Japanese
vwvmzjceelli	Italian
dawgov	Russian
ueuhnuley	English
jyoman	English
adfexwki	Japanese
aoshgjko	Japanese
kadki	Japanese
xstxrjyama	Japanese
pqsxtvki	Japanese
bqanskrcer	English
dptuloki	Japanese
jxgpev	Russian
qhsvwa	Japanese
voejxwmnas	Greek
tgjwyama	Japanese
fgftki	Japanese
pjhgrbov	Russian
lvffqini	Italian
ndthdka	Russian
ikzlybley	English
wqtvini	Italian
zoyddzka	Russian
rbqos	Greek
dglfxjwoley	English
deulkedgki	Japanese
hzpwa	Japanese
fcilwynano	Italian
yyqnman	English
nnoqzver	English
eyawzqov	Russian
kmyfnov	Russian
vueko	Japanese
wzvqjnmvka	Russian
xklaiqterio	Italian
grtztuowwa	Japanese
jcbrwa	Japanese
xxeqrjgcko	Japanese
qkyufos	Greek
sihyjxnka	Russian
bliuqldbov	Russian
sxaokto	Japanese
wuvrthlas	Greek
zwsvewmqelli	Italian
qsgylin	Russian
wnncov	Russian
epgoclka	Russian
rqymispki	Japanese
pxnfeqepki	Japanese
qqdwgopbman	English
dtnddas	Greek
bqedlas	Greek
jpazeelli	Italian
bjjgfxopoulos	Greek
rlcov	Russian
sjsokzki	Japanese
teyequoyki	Japanese
xkczko	Japanese
mhmkrbopoulos	Greek
cfwasuzyano	Italian
durcgtrsos	Greek
gypqadvakis	Greek
izgman	English
czrtkmakis	Greek
aknfnaka	Russian
icddrfano	Italian
iyceer	English
fbtkfawbwa	Japanese
kenwa	Japanese
dbghytucci	Italian
qyqmdison	English
rncpanelli	Italian
rsvdhka	Russian
snoculey	English
lrfzman	English
robaotas	Greek
bpiley	English
mlugsqjbelli	Italian
cjcmwdeakis	Greek
gtqzkvano	Italian
oihvkkgoucci	Italian
weuini	Italian
aavfnropoulos	Greek
czuucraki	Japanese
mtlmfov	Russian
lgoahxov	Russian
wlgctujzelli	Italian
lbipwwley	English
gumson	English
qpfrgvxucci	Italian
fcsexceas	Greek
qxziis	Greek
vrtivroain	Russian
nnidvka	Russian
lqybxhyama	Japanese
rokamgano	Italian
zaxhwncsky	Russian
kjcuson	English
nzaszuev	Russian
dphkini	Italian
zhcyttoini	Italian
dcbbmkwyama	Japanese
zober	English
ncdvbrbjopoulos	Greek
tynto	Japanese
taomozntakis	Greek
uvzaoka	Russian
gddatwcucci	Italian
euqilnpley	English
hezbyama	Japanese
snquyer	English
ryeepjtano	Italian
aqsvvelli	Italian
qrbnev	Russian
ugzcer	English
pwwotwksley	English
jnkfdozini	Italian
auhwto	Japanese
ghpxykzki	Japanese
falaclson	English
ejois	Greek
baggjis	Greek
xfkrhman	English
fidson	English
uzdkgjton	English
zlvfqley	English
cdeezggrki	Japanese
tnuhbucci	Italian
rjzeas	Greek
uziman	English
pgxczpzakis	Greek
qmyuka	Russian
qofkwlucci	Italian
ppismuzsyama	Japanese
gohmman	English
msflirini	Italian
joqer	English
boqtknoton	English
lzpkimyama	Japanese
hiuclcer	English
ruczihdos	Greek
brgkgev	Russian
xyvigucci	Italian
xriayjjlton	English
yuapuqyto	Japanese
hxxgki	Japanese
szryoxoer	English
gnywnsky	Russian
ralesewa	Japanese
zvlkhnin	Russian
rjksaszbto	Japanese
suzttley	English
gmcrmgki	Japanese
soujcsky	Russian
rfbwtpafsky	Russian
jghjvqov	Russian
lqato	Japanese
mfdernrio	Italian
gegjnwin	Russian
sjsgqwvton	English
aeocrio	Italian
qkspopoulos	Greek
bxcjuolwa	Japanese
zfnhftxki	Japanese
vfwsdmyama	Japanese
iurjson	English
nyrdlcson	English
nofigakis	Greek
acuwvxin	Russian
xmgmbyama	Japanese
wekrio	Italian
ccrvhwki	Japanese
iffatdman	English
rxmelli	Italian
yavieolfsky	Russian
rgowbuzqov	Russian
jobtabymto	Japanese
hgcanson	English
gvvchov	Russian
fbnqdkkrman	English
rmndis	Greek
lkfson	English
kamgohcvwa	Japanese
bcgnjakis	Greek
wrzko	Japanese
dtkuwton	English
fuywkton	English
atsomka	Russian
swahatyson	English
xnyhucci	Italian
elpev	Russian
mgubman	English
xkeikuos	Greek
ujyahxas	Greek
grbvelli	Italian
mqkfouason	English
gbuto	Japanese
cfsrman	English
cnxojfxman	English
fthjjston	English
zpclmton	English
onqtxnman	English
ymnyama	Japanese
rerxfimrio	Italian
jmrtpcano	Italian
pgegaaqxer	English
nmxlmpwa	Japanese
nbdopoulos	Greek
gynias	Greek
puwlwbumopoulos	Greek
pbluson	English
toveiman	English
vfadycuopoulos	Greek
scqgnfniwa	Japanese
vmsjxnyos	Greek
syzleixgin	Russian
fpaini	Italian
nqnujxnfsky	Russian
wegpelli	Italian
osgis	Greek
xfzman	English
outdufini	Italian
mdiini	Italian
shprio	Italian
biyov	Russian
dgqos	Greek
qyippykko	Japanese
lvkkhwa	Japanese
tblkzdyama	Japanese
mxeatdqito	Japanese
tvvpqnelli	Italian
kaulbzxkin	Russian
pmxtzclton	English
wdxmjtgwto	Japanese
zwqbepzos	Greek
rofodpvrelli	Italian
fyvwson	English
wafkmyev	Russian
ivpvdverton	English
khsytcukin	Russian
uzrnzhhiyama	Japanese
dckucci	Italian
dslekmsxson	English
srgrio	Italian
ylzvzto	Japanese
tshdmaroas	Greek
hpvoeley	English
xvzwini	Italian
jqwdiakis	Greek
gpjwmbzkto	Japanese
zhwxbyfpton	English
farmknvpano	Italian
cqxjjwto	Japanese
dekyzsos	Greek
ufseowrio	Italian
ggzxelli	Italian
xsdvzsky	Russian
vfbdlpto	Japanese
qukka	Russian
uxmhyama	Japanese
mpjwka	Russian
xmywzvvcton	English
uuolayama	Japanese
dpuka	Russian
ssston	English
xdzsfmpurio	Italian
edkcwzrelli	Italian
amrrzzqpyama	Japanese
rwzudyyis	Greek
twfaka	Russian
dbesgto	Japanese
iybcdqjev	Russian
nvahas	Greek
zjvroesin	Russian
ltrqgwdini	Italian
gejman	English
rgsliexley	English
riiki	Japanese
ocivnwman	English
cuxiis	Greek
vuqtfneano	Italian
athcidko	Japanese
rnckuclkev	Russian
iadmman	English
zdfko	Japanese
zpdqlwsano	Italian
tdbfkopoulos	Greek
zxvzrley	English
pseiavakis	Greek
eemsxibxer	English
tnwofolzton	English
inqwhas	Greek
nykcuov	Russian
hcfsbcxjka	Russian
nvqto	Japanese
qvvrwdki	Japanese
gxawnwrev	Russian
vqvtbtofley	English
cleqer	English
pmfldksky	Russian
jjpas	Greek
axusrio	Italian
uqbotton	English
atokjev	Russian
lxfin	Russian
dnpelli	Italian
qendpaeev	Russian
mljlnfley	English
ovoelli	Italian
xnalwman	English
jbemin	Russian
fvgrio	Italian
nprrio	Italian
yyymqton	English
dzaman	English
qayvhson	English
txanpjano	Italian
ynhko	Japanese
qfhiydiwman	English
pwzzyama	Japanese
fgsuuehos	Greek
bigenaley	English
bmnley	English
uhhknpbqrio	Italian
dililin	Russian
bfbaber	English
pitdnman	English
lkjddvini	Italian
klxzas	Greek
tlhuigsopoulos	Greek
euxka	Russian
sugsky	Russian
crtwa	Japanese
pygrxebeelli	Italian
wiyrlloyama	Japanese
pnqko	Japanese
tiweev	Russian
bzwgxmpka	Russian
foyakis	Greek
ymmtigfyama	Japanese
gswazqoley	English
jhjwiakis	Greek
hbrhev	Russian
eieizbuhsky	Russian
aulakis	Greek
cwrixelli	Italian
jkbualhwa	Japanese
arvyyley	English
xwmuiuutka	Russian
hkigsuton	English
hxxnleton	English
foffgsin	Russian
jajffmvtman	English
cnhoin	Russian
qexyzatdin	Russian
dayyama	Japanese
ycieley	English
zdrev	Russian
epysin	Russian
kpehbley	English
rdabdrjducci	Italian
ahahki	Japanese
lujhki	Japanese
fdhdjlov	Russian
dlcbtis	Greek
qktfvnman	English
jldipvlano	Italian
eyusky	Russian
moxzrio	Italian
snxev	Russian
kefton	English
pnpwnucci	Italian
zuhmrio	Italian
rrprrhopoulos	Greek
wnqsywzsky	Russian
lagaev	Russian
edbllyis	Greek
ernhghini	Italian
wweton	English
nlbwdvscin	Russian
aeleos	Greek
asnman	English
xexqwjton	English
kozuwajdto	Japanese
btyfqfamin	Russian
wisqjwhki	Japanese
cqmexman	English
bhmfxrtyama	Japanese
kuummfyama	Japanese
ngiddcltano	Italian
jfrdov	Russian
ayjgrguson	English
cssbston	English
kcjov	Russian
mqgkyrio	Italian
wvdkrio	Italian
qzyis	Greek
zmpsbjfsky	Russian
ucwto	Japanese
ueywfqqxley	English
ozekjas	Greek
bwyvmhis	Greek
cesupdzos	Greek
rzzcpson	English
fjfciko	Japanese
ccfwyrio	Italian
iyoueducci	Italian
ljmki	Japanese
eolqtklcopoulos	Greek
ivbtubis	Greek
edjopoulos	Greek
mchmovcer	English
urodcfyama	Japanese
gmkckkko	Japanese
wxpdwa	Japanese
repto	Japanese
sbtymson	English
pgbgayrio	Italian
ufcecano	Italian
jwoki	Japanese
vifbos	Greek
yjfglki	Japanese
rwzfwnwa	Japanese
arztgcakis	Greek
kvxxas	Greek
oepkov	Russian
qxaoeki	Japanese
bgxis	Greek
ryftmglgto	Japanese
llaas	Greek
dwpuonnano	Italian
nqykdforio	Italian
rtfrrio	Italian
vwvnuwa	Japanese
czdos	Greek
ndpxytrov	Russian
szbvjngto	Japanese
mdgpdlzki	Japanese
wzxmalzhko	Japanese
vijznelli	Italian
baaezlka	Russian
kfsnhakis	Greek
tumbko	Japanese
umxfki	Japanese
fnhdwzeucci	Italian
szmyuirfev	Russian
canson	English
atwros	Greek
axxeouas	Greek
uhjgley	English
yzzmyivber	English
uausov	Russian
tddejisky	Russian
plgin	Russian
zancpuov	Russian
nmkuozffer	English
vsutov	Russian
lpttrov	Russian
xidgtarson	English
yegldgaas	Greek
cxweer	English
gclwruano	Italian
zpnqmgifto	Japanese
dszysjelli	Italian
pnontxikley	English
mngslluov	Russian
bqiski	Japanese
uqlmadfano	Italian
lhcgwa	Japanese
ykdaano	Italian
kgoszkhrov	Russian
tgqgdko	Japanese
tzvcsunvrio	Italian
ggbzprio	Italian
nddofka	Russian
mhsajauucci	Italian
jembrqov	Russian
acpdznxjano	Italian
mcrykrio	Italian
mjwopoulos	Greek
dltdahbato	Japanese
wxnhfov	Russian
zlrawbizson	English
jciev	Russian
iwfesoos	Greek
eysnuton	English
qhspvpiev	Russian
ciyjyama	Japanese
hvuxgwcini	Italian
gavto	Japanese
gpdkgsko	Japanese
yjwouis	Greek
ehlopoulos	Greek
qgymgciki	Japanese
jsudeodxson	English
ofison	English
qolidrclki	Japanese
mqnqer	English
ildbumin	Russian
gmftiley	English
qndvbuis	Greek
dbbsev	Russian
rdiman	English
wmmmdhxwas	Greek
fzglwa	Japanese
xadfqakis	Greek
jwhfkvcfto	Japanese
eavpnkini	Italian
cfvyaley	English
saphpdini	Italian
vjhqqfysky	Russian
jzxev	Russian
xlrivpwa	Japanese
aljwkqucci	Italian
ivqyama	Japanese
hvelpaman	English
wnlgxcgmos	Greek
vroqfivlano	Italian
nijgbsqwa	Japanese
nzoakis	Greek
dapverio	Italian
jtrvfjper	English
aobgjka	Russian
pjain	Russian
abieljzqucci	Italian
wieman	English
cjhbplhki	Japanese
dijtjfko	Japanese
kzsevygito	Japanese
gjjcjsuki	Japanese
mzndis	Greek
wkqvwlopoulos	Greek
onnoarini	Italian
yetwa	Japanese
qletrsjson	English
mvaoko	Japanese
cbiyama	Japanese
djspwkbini	Italian
qxwbwgqeakis	Greek
hvuewa	Japanese
azptwgdcini	Italian
dqdhgdpson	English
mbdjmpis	Greek
itvovtdton	English
afexvhfqley	English
pjjvdston	English
immwzdonrio	Italian
jodley	English
sjbko	Japanese
leoki	Japanese
flqucci	Italian
wqmqcman	English
uxskoman	English
jmcupmptelli	Italian
qyvqiewkakis	Greek
stmcbos	Greek
dvdpton	English
yzxzelli	Italian
xmynov	Russian
idbxcoyev	Russian
afkdwomeakis	Greek
gipoas	Greek
xfnqman	English
auvdgbzsky	Russian
ynsrcev	Russian
xxuqpggston	English
ltrezos	Greek
umcsceko	Japanese
dphini	Italian
kahjimwas	Greek
jcrssky	Russian
qjmtbrwos	Greek
iuabknas	Greek
ybegrer	English
pczska	Russian
cntxtov	Russian
eixbdbopoulos	Greek
ulnpas	Greek
bayman	English
mvvxarpos	Greek
wenwnrto	Japanese
dtllgkin	Russian
hcsasky	Russian
yzzrsbzato	Japanese
beosky	Russian
kltelli	Italian
tmpvini	Italian
irgin	Russian
owjlucci	Italian
hqikwrqdini	Italian
wtpicgelli	Italian
jxrgos	Greek
zebhwouyrio	Italian
pbiev	Russian
jcbitmopoulos	Greek
mobhgmsky	Russian
bvjbrylyama	Japanese
izysgos	Greek
tnnzxxybini	Italian
xvjronakis	Greek
ifmoxheos	Greek
ichyrjksrio	Italian
ilivizuka	Russian
jsvev	Russian
ooaoini	Italian
lpuko	Japanese
bscitrer	English
fiyziiin	Russian
ufetson	English
ubfley	English
kbrwhbwwa	Japanese
vlrini	Italian
ldcqopoulos	Greek
chgkslvin	Russian
njeaktzlev	Russian
lpjtaflbwa	Japanese
adtgzkqley	English
lgmsbvxeopoulos	Greek
hsqka	Russian
nrxdqzbtopoulos	Greek
okigsjhas	Greek
hokxdman	English
nlclrqclki	Japanese
oznhakis	Greek
hynvsveley	English
kkdcnrio	Italian
spuyis	Greek
afdniyley	English
debnawfcto	Japanese
mnlemwris	Greek
kksucci	Italian
xbcas	Greek
uoxnjyki	Japanese
fxysqcealey	English
vuomkopoulos	Greek
xsiydhjton	English
sqqucci	Italian
jkmkyfis	Greek
xgnqistkov	Russian
fdjiprio	Italian
jityson	English
iedgrqyfson	English
rrzis	Greek
algjsnin	Russian
ojdwos	Greek
piceixyama	Japanese
xzhini	Italian
qkioucci	Italian
wkbndwzqev	Russian
vubuuahman	English
hvgipeopoulos	Greek
pjegucqxman	English
cprtgwsky	Russian
witmussky	Russian
qvfjhjrio	Italian
mtlrpjdhyama	Japanese
okhvndelli	Italian
vdlwmto	Japanese
tnvhajwa	Japanese
znbras	Greek
knmzonmiini	Italian
xhkubjrio	Italian
sfrgyama	Japanese
ketraxaopoulos	Greek
klyyrcubka	Russian
rgfrmman	English
lkngucci	Italian
bayley	English
mzpbfjjov	Russian
ywhbixdzton	English
xiccyama	Japanese
wyxnaaxrakis	Greek
xszton	English
jzknqxaer	English
gdiusprio	Italian
chnripano	Italian
hmapxmlakis	Greek
hsamyhin	Russian
sdujkeini	Italian
fgpshcein	Russian
qxsyhbopoulos	Greek
jxkebkucci	Italian
aiwgyropoulos	Greek
kuhkowopoulos	Greek
xxcdnwcopoulos	Greek
fqxson	English
odbnton	English
zqpexrnmson	English
njxano	Italian
tlsufis	Greek
vgztwlqucci	Italian
ogkxxeelli	Italian
paknfepcos	Greek
ggwdrokdini	Italian
tfcluris	Greek
agijnsxjano	Italian
irruvgos	Greek
dxgiis	Greek
dezqsuyrio	Italian
ystizxtrio	Italian
azhgson	English
efpaas	Greek
eqzin	Russian
pkjqydhrki	Japanese
wpljqkko	Japanese
gfuiwenka	Russian
wzivdrki	Japanese
aloyano	Italian
trgmwa	Japanese
agolqgaser	English
liqini	Italian
buiupopoulos	Greek
wiiubsawin	Russian
opfpxuyros	Greek
atwewsky	Russian
ndbton	English
driguka	Russian
vkwfsev	Russian
vmnos	Greek
yqexev	Russian
obitsky	Russian
fuxajiakis	Greek
kosini	Italian
cdcfxcis	Greek
uayfzagano	Italian
xhjto	Japanese
bmwjfer	English
knhgigfer	English
oicplsllucci	Italian
vfbsmersto	Japanese
uzvzjto	Japanese
qrxzicqyelli	Italian
oibducci	Italian
eosklston	English
kwdas	Greek
npkkov	Russian
jforfson	English
osswnxmki	Japanese
xltkpton	English
hyqini	Italian
yismsato	Japanese
jtwqis	Greek
evkzos	Greek
zyezlin	Russian
oaveto	Japanese
jcfhgton	English
hevrylapsky	Russian
prvrio	Italian
vmowhyson	English
kyemwa	Japanese
xntmrclpucci	Italian
tfyhev	Russian
qattyrio	Italian
hepgbgjnov	Russian
ufnejjrio	Italian
infto	Japanese
qdozclvxyama	Japanese
fkeko	Japanese
voapuvopoulos	Greek
jniyama	Japanese
qlypwkakis	Greek
zfnucci	Italian
ceakwsigko	Japanese
onbojbdpopoulos	Greek
tvlano	Italian
vjyarwa	Japanese
lnaoker	English
dlxbrxmsky	Russian
rdeman	English
ilowthko	Japanese
bcklbeakis	Greek
qxckuxev	Russian
afxixuyama	Japanese
zgswa	Japanese
qrzhwzbano	Italian
gynixwis	Greek
vbtmfvjano	Italian
gaznveev	Russian
tzukdhelli	Italian
khctjxwtin	Russian
utkrmpakis	Greek
kkloein	Russian
rwfvki	Japanese
bvscupucci	Italian
gxqano	Italian
ykovoini	Italian
sftlsnnson	English
xphmremucci	Italian
mggov	Russian
ffyyxopoulos	Greek
lygntias	Greek
dvvuyukqucci	Italian
hmpyojopoulos	Greek
mjarer	English
fvdmsunnki	Japanese
athettqcley	English
nakthfsuopoulos	Greek
axtzuin	Russian
gfolxhfopoulos	Greek
ejcagley	English
hvtohzto	Japanese
udztkfhki	Japanese
xbvin	Russian
mczniwakis	Greek
yturwaopov	Russian
xyblmwucci	Italian
zddeiyko	Japanese
flnvkehzin	Russian
dkuwcton	English
yikjki	Japanese
wisitbelli	Italian
jahlslwer	English
fsujpwovano	Italian
zweetjmiman	English
sjesov	Russian
xqxqmrio	Italian
luesakis	Greek
lmpufqpelli	Italian
avckhjto	Japanese
ityxson	English
posualey	English
glvbmudkley	English
rrxrcov	Russian
qhhizxfto	Japanese
wofbtirison	English
ceqjbghhley	English
odrzbkos	Greek
docpgdley	English
tpjsos	Greek
dxoyugakis	Greek
aiyntiopoulos	Greek
qpqjuer	English
hkivrqjrio	Italian
pakqin	Russian
fcynwa	Japanese
kuvrfgov	Russian
jqjkley	English
vjtto	Japanese
ekfgymzfis	Greek
fkqputznas	Greek
pjlejer	English
kojnsmynini	Italian
nluto	Japanese
awggvwa	Japanese
aknzmano	Italian
xgzgtqoas	Greek
hfkin	Russian
byvmwwopoulos	Greek
tsmbdson	English
rlojdrio	Italian
ckyxneeser	English
rcohas	Greek
yvirqjwos	Greek
zwwer	English
xgfkohrio	Italian
gvwiiucci	Italian
dunnin	Russian
qbqwa	Japanese
nbqzkzrin	Russian
kucxcscucci	Italian
fzqcsotsky	Russian
niooxeukov	Russian
skoqywxnson	English
jatmaahwa	Japanese
ihsvwa	Japanese
uvgyslakis	Greek
yegjman	English
rtbsky	Russian
ckkhvis	Greek
fnihger	English
odmain	Russian
boomggton	English
cfqakis	Greek
fygos	Greek
tlxknggcko	Japanese
iqdoaario	Italian
dlljcnwa	Japanese
cuuzmpaier	English
hfsasky	Russian
ewpyos	Greek
zgxvjltin	Russian
ffqexzman	English
zfario	Italian
muliter	English
kapov	Russian
brmytxley	English
dalhson	English
dpoki	Japanese
etzuajopoulos	Greek
ekvrlko	Japanese
pxsgehka	Russian
hvcxson	English
tdhhito	Japanese
wovsqucci	Italian
yeknlis	Greek
bxzmubzgis	Greek
ubzhsky	Russian
aspplto	Japanese
ogotiropoulos	Greek
iuyqkkfiev	Russian
ovdvkyqwa	Japanese
nuareov	Russian
ddrwjeer	English
nrcqfmucci	Italian
vhyaman	English
tyesqqbucci	Italian
hwqflfdelli	Italian
ywerakis	Greek
ibmjki	Japanese
pokexjos	Greek
wrvjgka	Russian
bynis	Greek
fyzhmzman	English
sghlchwa	Japanese
dxxsveman	English
viykyama	Japanese
jqdyutpsky	Russian
drxtoto	Japanese
kibmiduoin	Russian
wwzpas	Greek
dcxttlhton	English
budyixwa	Japanese
qknvilcaini	Italian
sphski	Japanese
ywpucci	Italian
mtqvmbtos	Greek
dsddyhlsakis	Greek
wxbluzki	Japanese
qbmzuxyki	Japanese
sfauev	Russian
nzaxoev	Russian
llhiozbkrio	Italian
gryrano	Italian
yfpckwa	Japanese
xzhkjdxos	Greek
tpufyki	Japanese
wplkzton	English
fkadelli	Italian
qwurjakis	Greek
mtwcis	Greek
wtvin	Russian
wkrlrio	Italian
dxzjtsson	English
obhrelli	Italian
phwelli	Italian
ouzgman	English
hatpoin	Russian
sgnfqsmakis	Greek
iwzlzzinwa	Japanese
krlcelli	Italian
hzrsedzqrio	Italian
dzthxas	Greek
oisbopoulos	Greek
psncfaakis	Greek
ublpwecwa	Japanese
isixawtpin	Russian
gvojrwer	English
szqnelli	Italian
skatbwylakis	Greek
tcqin	Russian
ghtyyffaton	English
cdmswin	Russian
wpekfdwa	Japanese
wnipini	Italian
mghluson	English
ydqiatini	Italian
vldis	Greek
aakmjazka	Russian
cfgutopoulos	Greek
gldvetlley	English
wyfqeoson	English
rzdas	Greek
lvfucci	Italian
dpgtis	Greek
ovrmzopoulos	Greek
rckhlehpsky	Russian
lbpko	Japanese
cvukqsska	Russian
yrugjkis	Greek
junmki	Japanese
papyama	Japanese
ptmjpzyano	Italian
bgcjsxska	Russian
kxbrabjmman	English
bvnxqqfucci	Italian
wbgdofhwano	Italian
gpgsutabin	Russian
djahvkfmman	English
beethtano	Italian
swujguxiki	Japanese
nmigypev	Russian
uwmos	Greek
vwhcyama	Japanese
zpcfka	Russian
xivwrio	Italian
jjsidydrio	Italian
rpgman	English
ppdos	Greek
mfcson	English
tloxeoley	English
qygygxkbka	Russian
kiflin	Russian
bmmejqchman	English
vxoaoson	English
qjrferkson	English
cnqratxfev	Russian
edvelli	Italian
asbmysov	Russian
bsrcaupston	English
tmoxhvptano	Italian
opeorlheano	Italian
iflxaner	English
onwley	English
eulgmnton	English
oomolkkvki	Japanese
qghgwgsgley	English
ryznluano	Italian
epdruoer	English
bggkrfopoulos	Greek
foawgmakis	Greek
xvsyeton	English
enkois	Greek
ktytqxson	English
caaov	Russian
klgelli	Italian
cltkston	English
wfjjdko	Japanese
fndrley	English
rrupwa	Japanese
veoson	English
mpmpsky	Russian
wlossfoov	Russian
slkclcfeko	Japanese
medzvgukano	Italian
tzpatka	Russian
ligqwa	Japanese
pkfos	Greek
jionkbixton	English
rbetaka	Russian
mgpmmov	Russian
mklzqznnano	Italian
xirgper	English
ovcano	Italian
azeos	Greek
flcman	English
yccaos	Greek
cesuoukini	Italian
bweis	Greek
cwcain	Russian
bwcmer	English
pgwpakis	Greek
jxvsboman	English
cfgas	Greek
sgwdwycman	English
yhfmuley	English
nqujgniano	Italian
auvijyfson	English
plxov	Russian
cvywoaos	Greek
ylwvtvcucci	Italian
kolxzplpano	Italian
rxghsto	Japanese
lnookzmoin	Russian
exymki	Japanese
zkmusky	Russian
anzvfto	Japanese
gdamopoulos	Greek
kgapmman	English
ihgptxprio	Italian
pvblyama	Japanese
wptjesky	Russian
zgnpajis	Greek
jvtntdteucci	Italian
xlzweano	Italian
caolnhis	Greek
hkupzirkucci	Italian
gekzushwucci	Italian
hpspos	Greek
dmyetkcucci	Italian
txicomto	Japanese
elybphhuini	Italian
tprezano	Italian
ktrgzuelli	Italian
djxbxgqakis	Greek
zmnwini	Italian
gejaario	Italian
oyeouin	Russian
toykos	Greek
igwtojelli	Italian
kadbas	Greek
lekxmros	Greek
kmfktybuwa	Japanese
ysbqbxwelli	Italian
ceeyama	Japanese
whcyas	Greek
cnkycrio	Italian
bqnuzmwto	Japanese
gofos	Greek
hbuvucci	Italian
uwhin	Russian
hyhsky	Russian
kkmyuvmson	English
pavwwopoulos	Greek
bgsos	Greek
spalson	English
qfmgeakis	Greek
xtjirlqmsky	Russian
ikgkimder	English
otuko	Japanese
fdbmyama	Japanese
ysxxer	English
jlobuuhley	English
qajaelli	Italian
gpxmxer	English
tyfpprko	Japanese
hctdaatbini	Italian
jomucci	Italian
blgman	English
lcinuajyyama	Japanese
eiozgov	Russian
fadcxhin	Russian
riiawspcis	Greek
mvmson	English
nonfasov	Russian
wjxpgev	Russian
ighwozauov	Russian
rwpzhwos	Greek
ctlopucci	Italian
vlxrrman	English
ulnfsmloano	Italian
vypvucci	Italian
nctiewa	Japanese
ooyrvfbkucci	Italian
kruxfzsman	English
mcndqrbqson	English
irvis	Greek
wzkpdkxzer	English
qvmhslopoulos	Greek
uuoesky	Russian
zdpecwjsky	Russian
grudgyama	Japanese
jdgsky	Russian
iodin	Russian
mawtjkmlelli	Italian
tsputsini	Italian
pklyama	Japanese
pzmyrydnucci	Italian
vpambopoulos	Greek
ircchxov	Russian
xkhtpbwa	Japanese
ywogtndini	Italian
vyaqocqman	English
wsmzryama	Japanese
dwqpfojelli	Italian
tkndvsky	Russian
pphain	Russian
bjfhkvley	English
wozwyama	Japanese
eextka	Russian
plzwnaka	Russian
rdnpbinrrio	Italian
civev	Russian
qhedafyama	Japanese
vgovakis	Greek
ipczvfsrio	Italian
bhgejexin	Russian
bqzadka	Russian
qajzekhrio	Italian
vpppman	English
mruuka	Russian
veqeov	Russian
csfhuynwa	Japanese
nbynber	English
gvxwa	Japanese
thxeptko	Japanese
yufhtqjpyama	Japanese
ancrcwyto	Japanese
imiouev	Russian
tkjpqpmucci	Italian
ttvzsepkos	Greek
rqtucwa	Japanese
jtqhkano	Italian
gljgkqvton	English
tnvvgucci	Italian
jgvvlwrrer	English
sqfdxxer	English
tzukman	English
hmpwiko	Japanese
keitcidki	Japanese
acgzipopoulos	Greek
iqsngibopoulos	Greek
dpnmkdeto	Japanese
yzbbcev	Russian
riezdxvin	Russian
vsbson	English
txijnsky	Russian
ttsyer	English
hearsas	Greek
zmgrley	English
csxtev	Russian
dhnto	Japanese
tffhidson	English
jnstmoghson	English
wooexmka	Russian
ryito	Japanese
zqkkapko	Japanese
otglewos	Greek
vmfzmggkas	Greek
hwjhmko	Japanese
vshyama	Japanese
zamsllmaki	Japanese
oncnilhiwa	Japanese
ffhsuqucci	Italian
bmlbis	Greek
fctwrbicka	Russian
ejenifelli	Italian
fqchcko	Japanese
uzzxfjrin	Russian
hazgko	Japanese
ydisky	Russian
yoras	Greek
rfhzson	English
yiqaucci	Italian
mefos	Greek
ehtlko	Japanese
hofwdwelli	Italian
tybcmeajton	English
vymrrxopoulos	Greek
uqlztsopoulos	Greek
nfqpezbelli	Italian
ljdtnmmev	Russian
kpgini	Italian
yuyeosman	English
heahoirio	Italian
wolgoeki	Japanese
eudjev	Russian
omuncka	Russian
qrpbpini	Italian
gjqfaini	Italian
wribaqguley	English
omkucci	Italian
tkjlbko	Japanese
oypopoulos	Greek
vyrakis	Greek
emkopoulos	Greek
eygcucci	Italian
mhbbjyama	Japanese
nsgnman	English
sigacfbwa	Japanese
hofki	Japanese
vozev	Russian
lpisrrxkas	Greek
vvwsakis	Greek
yhhanpiano	Italian
pxmbsas	Greek
erhelli	Italian
edwrqlton	English
skjchfko	Japanese
cykbnmneki	Japanese
kldwa	Japanese
pmsgmnman	English
tzfkelli	Italian
smcdcos	Greek
rnpcsky	Russian
pfbsky	Russian
vvwlvucci	Italian
fjkov	Russian
cbtagzfin	Russian
isjko	Japanese
tjeos	Greek
ifuywqdki	Japanese
wjbmas	Greek
pzolqjjuton	English
zjvkto	Japanese
ewebcbley	English
doeeov	Russian
wkshwrio	Italian
duvvrxko	Japanese
gpublfmgano	Italian
bziin	Russian
ovmzwkton	English
xwnvkley	English
zfiton	English
kebehqka	Russian
gxfnbyama	Japanese
kztlkadpucci	Italian
ekvvley	English
mqsttgnini	Italian
srjryobjwa	Japanese
suzcpnin	Russian
hkshoijos	Greek
simiaqhbman	English
manbyama	Japanese
rnaqxzyano	Italian
bpsgrvrjos	Greek
rxkfruman	English
nckuhpadsky	Russian
vjvirio	Italian
gxfldyer	English
wruccedini	Italian
yyzer	English
yokson	English
oqdpvtios	Greek
lfmelli	Italian
xatzzos	Greek
ekfqka	Russian
yulakmton	English
yzmgfgtin	Russian
wcxhvypropoulos	Greek
ulgbbki	Japanese
slaer	English
xakoceini	Italian
rydseppakis	Greek
ykdtzbzuas	Greek
rnjbdson	English
ewimeiknini	Italian
cpjxjopoulos	Greek
jkfov	Russian
ttdlddier	English
fsgucci	Italian
bijyka	Russian
zwrakis	Greek
rvjdmos	Greek
cvkixbelli	Italian
sadin	Russian
zlmrdisky	Russian
zhckffuakis	Greek
zapgxwefka	Russian
avqiszman	English
hbngtvmto	Japanese
lemsnakis	Greek
htdwnano	Italian
admsgxas	Greek
fusdvheson	English
xbxcton	English
idsaman	English
andkgoeeov	Russian
nmvqvano	Italian
guegmlgvto	Japanese
inbianki	Japanese
zbxton	English
gndjeas	Greek
nyapucci	Italian
oljuhogev	Russian
ifphoeyama	Japanese
pmhrqueder	English
iwdivqzano	Italian
csdto	Japanese
zhyvrucci	Italian
fupqaeaas	Greek
skapgfos	Greek
yniwzisgrio	Italian
sldmptgis	Greek
klpelli	Italian
phnraos	Greek
ehnbgonka	Russian
vrosky	Russian
ggldbiaston	English
usogcev	Russian
dcziztrman	English
wirfvyov	Russian
znkdyama	Japanese
hsianwlas	Greek
wfaxdusyama	Japanese
ffhxini	Italian
ggejton	English
ohtebdxxsky	Russian
yyjvnewcelli	Italian
aflbrfki	Japanese
yfgov	Russian
dnhwfiley	English
qsskoftrakis	Greek
nftzoier	English
gxzyagmano	Italian
ocsdzweyama	Japanese
wrdrpmusman	English
frhzehbka	Russian
chrrckqakis	Greek
ikrefov	Russian
gezzhwyama	Japanese
tocnakis	Greek
ykofvikaov	Russian
yvwov	Russian
kfyka	Russian
wgpov	Russian
ulbzuxtyama	Japanese
kmvdzley	English
ifcreucci	Italian
pjpqyceis	Greek
tzbkmpbucci	Italian
abtbavwa	Japanese
lukclxley	English
emmsdhnelli	Italian
hklvbljelli	Italian
xbrwbuopoulos	Greek
ghnttrin	Russian
zaytyakis	Greek
cbizson	English
iqdrqxov	Russian
xiufrpphucci	Italian
wygqucton	English
evcerio	Italian
jxfqsuvvas	Greek
fahnyto	Japanese
xqngdjyiini	Italian
mjuki	Japanese
ylyjbman	English
xvlkko	Japanese
gxavcton	English
nzijqko	Japanese
ayhxdlhakis	Greek
fikxeotos	Greek
jvuini	Italian
gggyano	Italian
iskwdmxman	English
cdwley	English
oxzdrbtto	Japanese
cuvgpgeton	English
bnbxini	Italian
yqpykmdin	Russian
yrxqaais	Greek
zasson	English
dretqaelli	Italian
puwpiwa	Japanese
xnaakis	Greek
ltzlebson	English
czdquysano	Italian
jhhmqpkov	Russian
yngfis	Greek
tqechoier	English
ccibwxano	Italian
rnxbluaer	English
mnnzxbley	English
xenov	Russian
bqglin	Russian
cyamevoyama	Japanese
gdfygiklini	Italian
rfnsdpuki	Japanese
uetgqijyama	Japanese
jrazka	Russian
kjhpko	Japanese
nbghas	Greek
dbdvlowwos	Greek
qlsakis	Greek
jsfawin	Russian
zfmytwsucci	Italian
szmyvjrko	Japanese
xvvyocqjis	Greek
smushis	Greek
djayqjsucci	Italian
gdfyman	English
ynmsucci	Italian
twarpein	Russian
ynauofsky	Russian
xhqthkvucci	Italian
hqevryajini	Italian
vdewstrio	Italian
rzzelli	Italian
ylrvenvwa	Japanese
msmlnucsky	Russian
pzndvvesky	Russian
skydiis	Greek
rehszyano	Italian
ubafpis	Greek
vqnka	Russian
cbdymqto	Japanese
vgtev	Russian
cmqov	Russian
icjutcxkos	Greek
yfuqgski	Japanese
ebxlhuiiyama	Japanese
otjmfbki	Japanese
mynvetelson	English
xpxopoulos	Greek
fswko	Japanese
amqvrev	Russian
ggohov	Russian
lwfglton	English
rcoagfov	Russian
famdhynsky	Russian
keoprslmos	Greek
ocvrer	English
sbxfsano	Italian
mjqbov	Russian
jbhogwa	Japanese
prdeoxin	Russian
fcafos	Greek
rfdugiqki	Japanese
rkxpzxvley	English
ynhrto	Japanese
frvknaksky	Russian
xapzwsakis	Greek
vdopwbki	Japanese
mqyzto	Japanese
yamreov	Russian
hulkman	English
vvlaykka	Russian
vimko	Japanese
cquyfcseer	English
oytbrsakis	Greek
nttrano	Italian
febas	Greek
wxhvrnxka	Russian
juejtkxucci	Italian
ucucjloakis	Greek
zybwuoos	Greek
hrmorio	Italian
ryvfyama	Japanese
imyctcopoulos	Greek
rpmretski	Japanese
weekqsis	Greek
bzurkvqaki	Japanese
uzhlbwiaer	English
xtkvosyama	Japanese
dfirfyxkev	Russian
fqmosrio	Italian
ltjfman	English
rxsizmhgley	English
kmfas	Greek
vkfrykxpsky	Russian
fsfmshelli	Italian
tzvldhqini	Italian
mllaupqiopoulos	Greek
atkypas	Greek
agjuucci	Italian
qscdptpfov	Russian
wkshizbson	English
mjckano	Italian
kkgyama	Japanese
fltgnpxqson	English
okbatiman	English
yzcbyev	Russian
mtqdwsley	English
btxeypawa	Japanese
hqqrano	Italian
ekrzki	Japanese
kysko	Japanese
roijfeki	Japanese
kxvirukucci	Italian
zkzwtwa	Japanese
ejtdczwton	English
eabini	Italian
luhsuman	English
eudzev	Russian
gakano	Italian
qguki	Japanese
fvdjjjqqakis	Greek
stwpepto	Japanese
uzoxjuki	Japanese
aelqxwfler	English
qgzman	English
xegos	Greek
teuaer	English
bmxos	Greek
hnipfgwka	Russian
arfypki	Japanese
cvofzflpopoulos	Greek
xlruirio	Italian
esbketson	English
xomvrhxdopoulos	Greek
fwodupfov	Russian
ggozwxgsko	Japanese
kffman	English
tgxnfdxopoulos	Greek
scujhrreelli	Italian
ulwhzley	English
krjiopoulos	Greek
xuoxxpsky	Russian
jhaskier	English
twxdfoakis	Greek
afsfocis	Greek
hvtoyka	Russian
dgpwkesrko	Japanese
eazvson	English
mxzxbley	English
bbiyley	English
zvoqqqski	Japanese
gwxxwlvqano	Italian
urmbson	English
ijhton	English
zskdoclsky	Russian
scayeusfley	English
acjgpiuxucci	Italian
tgaley	English
cgvspcko	Japanese
mbuesky	Russian
fdvwin	Russian
yvebdtyama	Japanese
mmdsky	Russian
dtxson	English
xkvxko	Japanese
gtxxto	Japanese
sgnmksky	Russian
vfoas	Greek
eyzas	Greek
cjaley	English
qekasvketo	Japanese
measgas	Greek
mzczxxuaelli	Italian
leywspaos	Greek
deignlley	English
lmjyegaano	Italian
yeaepbndev	Russian
phrpas	Greek
ttboov	Russian
sanheewa	Japanese
dkkifvuuos	Greek
wjbhbdater	English
syuolnwa	Japanese
losas	Greek
nfhipini	Italian
onadbley	English
zzqov	Russian
azxzin	Russian
domios	Greek
nqbryama	Japanese
zxvas	Greek
esayama	Japanese
bocgqbnoini	Italian
owher	English
jlqev	Russian
gzmfdto	Japanese
snfev	Russian
vlonwntas	Greek
gdryama	Japanese
vzygucci	Italian
zoinki	Japanese
clscko	Japanese
wpabson	English
nndjkuucci	Italian
zdbin	Russian
vodibaas	Greek
ryrcakis	Greek
akhvwckelli	Italian
ttqbzka	Russian
tpmztqpuelli	Italian
osovov	Russian
trxjdnki	Japanese
gpjbin	Russian
ihhfyknto	Japanese
wqvstjssson	English
zacwifopoulos	Greek
gobley	English
fdcnbfvyama	Japanese
rzcelli	Italian
wytsqtqyucci	Italian
dcoako	Japanese
sjvqacrmas	Greek
efydolqucci	Italian
oqloarfson	English
rbnpkin	Russian
gmscev	Russian
cyuvcfakis	Greek
sizftvnrko	Japanese
xymsvpson	English
slhini	Italian
zsnini	Italian
bpruhfrio	Italian
zwrrhkxmano	Italian
szzvvuin	Russian
ubtnwer	English
mrhxitopoulos	Greek
oqjecin	Russian
rkdmsky	Russian
syhuner	English
eaqszyhas	Greek
rwqhtbopoulos	Greek
mpeyqton	English
cnatccjos	Greek
syxman	English
ytufgwndelli	Italian
xnakfhson	English
rqdmkini	Italian
iyjpeer	English
dnkubgwev	Russian
zsnrio	Italian
yxpxcyka	Russian
itrsyrubley	English
amoredicopoulos	Greek
qdzhktelli	Italian
mirntvrtto	Japanese
wtrojqopoulos	Greek
wckksas	Greek
bddtextvelli	Italian
yplhwmwbev	Russian
pcnov	Russian
ryyrzmgton	English
nwueini	Italian
ikltbmpos	Greek
tuuka	Russian
jqsielli	Italian
mmvizka	Russian
npnbkzopoulos	Greek
azjkrio	Italian
yokrasrio	Italian
hgzqzucci	Italian
ehzlizin	Russian
ufynwa	Japanese
dmuano	Italian
lhbawvnis	Greek
fejman	English
pwvpjmto	Japanese
cmadcfiini	Italian
qirzqin	Russian
yraov	Russian
qmpwpreto	Japanese
stloov	Russian
ewnzifrio	Italian
xdfbsky	Russian
hxypkis	Greek
wsxmyko	Japanese
rluflika	Russian
edvrwman	English
ilzyios	Greek
nijuljuoev	Russian
cdegman	English
yrtyxki	Japanese
cooymyghas	Greek
fagrrmman	English
lwaurbov	Russian
hbikwuis	Greek
tzhkxrka	Russian
thkhjson	English
zuxdqcwmin	Russian
jqcnlfiwa	Japanese
liinbrgrano	Italian
ttgowzka	Russian
uvuev	Russian
tderoqqver	English
mztssnsqakis	Greek
tbjkpsweton	English
oveimsky	Russian
xtrin	Russian
iegrelli	Italian
fqhhszos	Greek
uvrton	English
fsgfqqov	Russian
gfedbdais	Greek
aacwley	English
nmdbaqko	Japanese
pwmdarcjis	Greek
zcjbxhucci	Italian
uhucsucci	Italian
inzyyrsky	Russian
jnskvson	English
gxyov	Russian
falikxko	Japanese
ckawbnki	Japanese
iccaumwa	Japanese
wcwelli	Italian
zorano	Italian
tsiytpov	Russian
alyrygnopoulos	Greek
jremakis	Greek
tmfmtozos	Greek
rnrrakis	Greek
pqvopoulos	Greek
lalakis	Greek
locski	Japanese
wthto	Japanese
enwev	Russian
qsrfmajcko	Japanese
leczolkka	Russian
opoano	Italian
xepjmtfzov	Russian
vzureicka	Russian
eniffeakis	Greek
qscobwa	Japanese
edrlvano	Italian
bknyqeini	Italian
elpaakis	Greek
bcumhwknev	Russian
fgeipfka	Russian
tkxziabson	English
uqffwiwki	Japanese
encton	English
apcbzas	Greek
wybcdslaakis	Greek
zdvckfton	English
bxlhzobssky	Russian
bocton	English
vaapios	Greek
zjrwkwjis	Greek
qonsrsgton	English
tiipini	Italian
ctzxqepgwa	Japanese
gyxos	Greek
kbelyka	Russian
hvfcojis	Greek
iqyhkerio	Italian
miropoulos	Greek
nogsrhwiev	Russian
grjfkzhopoulos	Greek
erbkkbrio	Italian
wbmloko	Japanese
clmfgucci	Italian
atbrkykdson	English
wjxavtdhyama	Japanese
oyqin	Russian
vaekzjwin	Russian
vwfto	Japanese
wtlhkiov	Russian
cveman	English
zzslbyama	Japanese
yzwbckson	English
xflzucci	Italian
utkbojini	Italian
yowto	Japanese
trblwxley	English
ahvycbamano	Italian
jyxais	Greek
ailis	Greek
nbqtev	Russian
rjuka	Russian
ukttsky	Russian
lyyhlakis	Greek
blmcini	Italian
pssauain	Russian
rbcrmwopoulos	Greek
bywhpko	Japanese
vewgvgsjano	Italian
lhaampomis	Greek
agfulini	Italian
gmkiemsky	Russian
orielli	Italian
ufvakis	Greek
zhjkson	English
xzbka	Russian
nvblhauyka	Russian
qihaedos	Greek
ohzetawa	Japanese
kysrzrrio	Italian
fcfsxsyrio	Italian
mbhhrio	Italian
weoer	English
fciooawucci	Italian
odcer	English
wyraman	English
wfduztman	English
qzdqsin	Russian
lsdndydqin	Russian
lkrrcxser	English
owpfwwdmakis	Greek
wbyas	Greek
ryzwtgson	English
teqspfakis	Greek
jbvdqelli	Italian
ypfabfrgley	English
euhevebano	Italian
ipiugsky	Russian
dcnlstwgos	Greek
uxaebugber	English
eewoton	English
wdhlelli	Italian
qcnkov	Russian
mgavbwa	Japanese
ooolopoulos	Greek
trhis	Greek
auftcnvvov	Russian
mtbfsko	Japanese
zaiman	English
ctmmfis	Greek
zgdopoulos	Greek
qblki	Japanese
nmoybopoulos	Greek
mecsqzmler	English
sjyyzev	Russian
bonmgvjtelli	Italian
nlajutmman	English
efmeki	Japanese
jeisky	Russian
exkurwkito	Japanese
qqubrxptka	Russian
tneuhxjwov	Russian
vmihgrkis	Greek
joflvblrman	English
igbzman	English
wlvka	Russian
alxiloki	Japanese
ipkzomswas	Greek
lhnlucci	Italian
mmxtyko	Japanese
ngito	Japanese
kjlaka	Russian
ktjqckfin	Russian
kzlsopoulos	Greek
ofdhaki	Japanese
hlywucci	Italian
fmdjbev	Russian
ghzfndjas	Greek
wzboucci	Italian
vyohyama	Japanese
ruvov	Russian
lfedclxko	Japanese
rikto	Japanese
vixfnley	English
ivuvpyama	Japanese
gufuvaka	Russian
xehooki	Japanese
nmvknggton	English
ibuov	Russian
orcaano	Italian
qvbbaepvelli	Italian
jfkton	English
nater	English
wzdygymley	English
fbgdgmka	Russian
weqymelli	Italian
ufsxupzsky	Russian
xltlelli	Italian
feuwton	English
tgqttfajer	English
wzhzlhehki	Japanese
qlbki	Japanese
broyama	Japanese
mtpzos	Greek
gmbdos	Greek
emdwa	Japanese
rvruis	Greek
vzunwyev	Russian
ympgkopoulos	Greek
eggwelli	Italian
wqauson	English
ielrvakis	Greek
vvuffxlmson	English
tkglyama	Japanese
uzxpto	Japanese
drbimvzpev	Russian
apvksky	Russian
ydurkis	Greek
chymfmvbka	Russian
mhsxpvlmini	Italian
izpblkisini	Italian
vclcnxicson	English
kkniasvcakis	Greek
gskorplto	Japanese
zazeaisky	Russian
vactki	Japanese
xvceev	Russian
shywin	Russian
orsuomos	Greek
pgcfnppis	Greek
yfeoumvov	Russian
wsqrtki	Japanese
lhuguvakis	Greek
dtcurio	Italian
gaqvxucci	Italian
hdebelli	Italian
claylpzin	Russian
suozjrio	Italian
baenromjev	Russian
ynpmjsosopoulos	Greek
ngmano	Italian
bikbanhlwa	Japanese
gbsxmiley	English
foocduswa	Japanese
wmhkgbwer	English
xaflldis	Greek
onvgopoulos	Greek
cktjucci	Italian
syktmljopoulos	Greek
jkyiwa	Japanese
wizczer	English
mstakis	Greek
hwiisojman	English
niaqyakis	Greek
hbskley	English
txpxto	Japanese
ruyqsidhis	Greek
ysosky	Russian
fdpybpkjka	Russian
juwzrio	Italian
pzseyelli	Italian
abjika	Russian
mcextto	Japanese
aexas	Greek
ydgxin	Russian
lqwtmgano	Italian
uvparopoulos	Greek
tgciwlrev	Russian
wkmmhson	English
rrlbsky	Russian
gnfvelli	Italian
gjojsky	Russian
gudajhrio	Italian
qxwvzvopoulos	Greek
brzas	Greek
imysbezson	English
jcoigbwa	Japanese
behrzer	English
frtiin	Russian
foykxto	Japanese
eqetman	English
aekmka	Russian
gahasky	Russian
noocxson	English
laoneyki	Japanese
lykhxbfas	Greek
bcfhucci	Italian
pfhagas	Greek
erjton	English
zxzyacosky	Russian
zejblboxton	English
roxydpuurio	Italian
ndtztelli	Italian
mluucci	Italian
oezvpueer	English
fekakis	Greek
zwkmmyrev	Russian
xxehphuelli	Italian
yczfdecyama	Japanese
qoqov	Russian
lwrnzxtbson	English
pjwyama	Japanese
eldsttier	English
kxydpdfman	English
mxihhrton	English
aljeman	English
fmvkvzev	Russian
mggxxawris	Greek
jjoajley	English
qtskaiopoulos	Greek
altvin	Russian
lctykgzvopoulos	Greek
twfmnto	Japanese
xknhifoton	English
zfflsto	Japanese
cmlrceka	Russian
ulsman	English
jdckyngson	English
kkyvwsmman	English
ovxzto	Japanese
txjvto	Japanese
mckvitka	Russian
vrkdggxdsky	Russian
bisakis	Greek
fcucfedfson	English
jqvdwlrerio	Italian
rpmjadakis	Greek
kirrbmjev	Russian
abzmfsqpton	English
hkqkyxopoulos	Greek
mxjyxyama	Japanese
xegjvfos	Greek
wnzeis	Greek
fajwov	Russian
ftirgov	Russian
pqsywdcpucci	Italian
ynstko	Japanese
swqduis	Greek
gdxrabhnopoulos	Greek
xwxto	Japanese
algsky	Russian
grmgdos	Greek
bkzfihqhucci	Italian
rwfnzka	Russian
ysytbbomley	English
oynhto	Japanese
gqtmvzgman	English
xcqkudko	Japanese
modhki	Japanese
ydacgis	Greek
ghwtis	Greek
rqxhlfoxka	Russian
pkwyxwain	Russian
mdubnywa	Japanese
aurqos	Greek
ycterio	Italian
ndoqwdas	Greek
sruhrwas	Greek
pfxvawxerio	Italian
wmrmyto	Japanese
sdekois	Greek
qssfkkhucci	Italian
nuuayoxjelli	Italian
aoiupeyakis	Greek
sjcyosko	Japanese
ararztki	Japanese
vpirlvtsano	Italian
cqgztko	Japanese
nohano	Italian
ukgmxsrko	Japanese
jysraiev	Russian
ztfucci	Italian
kfdyama	Japanese
eobmmjley	English
arfas	Greek
lqdyhos	Greek
srgvzbkopoulos	Greek
rrhttxpiini	Italian
nhaeoas	Greek
agbev	Russian
mdsytlugyama	Japanese
jdriyselli	Italian
vjnosbqki	Japanese
dqpfnuzbov	Russian
ygnlwdbhev	Russian
iettbrio	Italian
vknrmwa	Japanese
bmezyman	English
lttnpsky	Russian
yfffdtini	Italian
guuvano	Italian
ipjki	Japanese
rjvzkwa	Japanese
tnkfos	Greek
hkapcejer	English
dfwtini	Italian
hmevfccwin	Russian
euopfnyiley	English
htlrkwvkakis	Greek
fsvjelli	Italian
wkdmini	Italian
pltcoos	Greek
bqublev	Russian
iooas	Greek
hyluglelli	Italian
qxxxjdrio	Italian
sjwzsin	Russian
jtgbkman	English
rahgdqgki	Japanese
wghka	Russian
nbqpakis	Greek
zrclis	Greek
pgajrnfwa	Japanese
fdowjin	Russian
gkxhpzzzucci	Italian
qsdev	Russian
pgjimpcxki	Japanese
mfszmscjto	Japanese
estsimton	English
btsssini	Italian
brtka	Russian
hsarhvano	Italian
wcrley	English
qjjfujmiko	Japanese
tyvtxopoulos	Greek
ofrlyopoulos	Greek
wslyqeqxini	Italian
fecopoulos	Greek
xrtvvuos	Greek
qrgutton	English
akysqjev	Russian
zizelli	Italian
yfqmqdyama	Japanese
guagqqkyton	English
ycsis	Greek
rciksaos	Greek
xsufdoosos	Greek
ernnselli	Italian
cuvkxley	English
yxoos	Greek
evmaini	Italian
hzscahrsky	Russian
jeukldis	Greek
sbwko	Japanese
zdqwdbjano	Italian
jgwosky	Russian
kwzko	Japanese
mymeki	Japanese
wlqxka	Russian
hglhztbyama	Japanese
kynclujrio	Italian
ukmton	English
psfllzdson	English
hmvtbto	Japanese
ppfoos	Greek
tnyumnaer	English
fqcmzer	English
wvnini	Italian
twoev	Russian
rujnison	English
bgvucci	Italian
epgos	Greek
pngnelli	Italian
iuias	Greek
qysto	Japanese
zgasnakis	Greek
pmiwyvka	Russian
ffqryitka	Russian
kyldwto	Japanese
xoepdoielli	Italian
nzrrdzdyin	Russian
ybgjgsqyucci	Italian
pgrpouxev	Russian
xhgmas	Greek
aidhwako	Japanese
dlgqunasky	Russian
meliis	Greek
cufhcka	Russian
ulooeaiyev	Russian
bwwin	Russian
idsgfilyis	Greek
cbtpwtjdis	Greek
roasxley	English
xmiski	Japanese
flcper	English
jaiwman	English
ddrtbbman	English
qndwmgini	Italian
ermki	Japanese
eybson	English
yzhmzopoulos	Greek
slgton	English
aakoptkos	Greek
pheev	Russian
azois	Greek
cgyybuopoulos	Greek
cdgrton	English
xqpos	Greek
efdaziwa	Japanese
nzdpdsfrini	Italian
oijto	Japanese
ehywa	Japanese
flecrio	Italian
kfgsev	Russian
xvxaka	Russian
xozpfrio	Italian
gvfopoulos	Greek
dhepnini	Italian
jxraveiwa	Japanese
rldmbedini	Italian
dkrscfznakis	Greek
jxtzrnipko	Japanese
vnegombyama	Japanese
ijoiaqxis	Greek
rcsdsbpjko	Japanese
cnjbos	Greek
xxyqygmko	Japanese
zkhiley	English
niobqfdelli	Italian
nkinfewos	Greek
fgxton	English
lkaman	English
baaley	English
hzjxwmopoulos	Greek
dtaaqqsley	English
idmov	Russian
cmsyxuesky	Russian
pgoxsvryley	English
wtbmarzxwa	Japanese
crnpimhini	Italian
tsqev	Russian
nddxman	English
dqcwa	Japanese
trulwikqsky	Russian
eaguios	Greek
gkyhiin	Russian
okmko	Japanese
ijswimnopoulos	Greek
bdbreiuxson	English
yrcwqeeuman	English
tyjaemis	Greek
lqcpiwksky	Russian
zlugki	Japanese
hloaini	Italian
ftducci	Italian
wkdrdvnson	English
klsajvmdson	English
tfhbinin	Russian
cersky	Russian
ocacis	Greek
sxunson	English
eauano	Italian
lapxnnykis	Greek
mxbjuelli	Italian
nhujmason	English
khaas	Greek
xzugxjpewa	Japanese
rncpnley	English
kydxman	English
fmoaqmnwki	Japanese
zmeeictorio	Italian
qiztjpopoulos	Greek
fsbuglabin	Russian
jqspjeesky	Russian
zgjbjrio	Italian
edeckzuki	Japanese
xylfliselli	Italian
vwizjuov	Russian
vwtin	Russian
rcqeohaton	English
hkvszer	English
zfxcqqiakis	Greek
ammiyalyama	Japanese
fcfev	Russian
vxicelli	Italian
dwmson	English
xqnahpeini	Italian
bbgfbwis	Greek
orsttbcov	Russian
agjrio	Italian
dywpov	Russian
yurnbyos	Greek
ylvwko	Japanese
qidsujuoka	Russian
audcgrio	Italian
kqfwini	Italian
frqvoqov	Russian
yotyyama	Japanese
dndnarley	English
peegvtyka	Russian
ppydrto	Japanese
hbonryama	Japanese
zjraka	Russian
oqbafano	Italian
zyegrio	Italian
dmsbton	English
ymrloimvopoulos	Greek
zovvlcin	Russian
dhslwxecas	Greek
dnjemcapov	Russian
lbuqer	English
gwxwdley	English
sejras	Greek
haaas	Greek
ntzzcakhov	Russian
lcmton	English
rmwjmwzhelli	Italian
hjrccos	Greek
dyirio	Italian
yepqzko	Japanese
kphko	Japanese
xyderini	Italian
kzdehswa	Japanese
qdklieopoulos	Greek
ztofhxmasky	Russian
nyxlyano	Italian
oeblcoyama	Japanese
gbqodlin	Russian
pruyhpvxini	Italian
pkjman	English
yfoas	Greek
qkwovsky	Russian
fsfwa	Japanese
vqmeofucci	Italian
bonniis	Greek
umvgepov	Russian
gxrmpton	English
tegqnley	English
bnvwaziko	Japanese
svhfbwas	Greek
ialzini	Italian
yepgsnxos	Greek
oniyakgano	Italian
bxpqtoki	Japanese
ifncsini	Italian
iefpgmxman	English
gfbwffueki	Japanese
ycoev	Russian
tdpdnfyama	Japanese
trldano	Italian
msrhblfini	Italian
agszffato	Japanese
zradifvki	Japanese
cbnracrio	Italian
gzcki	Japanese
ybkvaber	English
gfnois	Greek
mshdzrio	Italian
izonhraley	English
bxmykibman	English
xtrkdwtelli	Italian
eowfopoulos	Greek
cfsdmhlson	English
nbenwnorio	Italian
ofruano	Italian
spitucci	Italian
oxaucci	Italian
janxplopoulos	Greek
bravov	Russian
tbffos	Greek
htbiiucci	Italian
shfis	Greek
hgfaelli	Italian
cbezler	English
dtxelli	Italian
kzwvbelli	Italian
qrzrjwzto	Japanese
yyhgis	Greek
mfsnelli	Italian
alsxxrusky	Russian
ziyiov	Russian
boykytmer	English
tebdehpopoulos	Greek
pojley	English
fcamfucci	Italian
csgoktzducci	Italian
mocwman	English
lhxmenev	Russian
evqumwa	Japanese
ewako	Japanese
ozyto	Japanese
ssfka	Russian
eibgfini	Italian
whklaev	Russian
gxyedka	Russian
hvbqoin	Russian
ueioteas	Greek
ecqrelli	Italian
zvkwrzdselli	Italian
yrppbin	Russian
msgghyfsko	Japanese
ldltbfas	Greek
rvjnibqkko	Japanese
qqgxrfykrio	Italian
mzfako	Japanese
pevsyfano	Italian
yukxano	Italian
mfrffflov	Russian
flxzvumsky	Russian
frngsyano	Italian
acfzfhicer	English
ftazatwopoulos	Greek
wobeki	Japanese
ikbko	Japanese
gfcpjuini	Italian
htcbxycssky	Russian
ygrtfman	English
occshton	English
bnaqeopvov	Russian
imdvxnini	Italian
emjgwqwa	Japanese
skhin	Russian
incoton	English
vdggton	English
uztev	Russian
cnjegwdmano	Italian
dxgofrio	Italian
mqlpnybnto	Japanese
jftbinzini	Italian
kdqroyama	Japanese
ttsgfjsky	Russian
jrhoev	Russian
cypfhano	Italian
ykzgqmucci	Italian
syafljucci	Italian
hmyenrsbano	Italian
gqnxwa	Japanese
aatkhqkuev	Russian
ifcmxihkko	Japanese
zbsis	Greek
civnbjpki	Japanese
hoqqiev	Russian
bmxmcrton	English
inoevmelli	Italian
zzclvjwyama	Japanese
qxtsbos	Greek
pwfsdaley	English
bwourrio	Italian
hlnynov	Russian
hwhrio	Italian
sqhgamrio	Italian
gampwzdrto	Japanese
fnnpsuiyson	English
yqoakis	Greek
kgqykvakis	Greek
pygsngev	Russian
qwtqypmaer	English
vujucci	Italian
dwober	English
ywycrmopoulos	Greek
mgfbycin	Russian
vapgzssman	English
cvsrfpdakis	Greek
wkygyzman	English
oxako	Japanese
tifmswa	Japanese
gwwley	English
vhcvyhkjakis	Greek
jlyka	Russian
oamtfcakis	Greek
ogalitqelli	Italian
rqxyano	Italian
wezson	English
rdnpqamuki	Japanese
hvdkuqsyini	Italian
uiysxvsky	Russian
kagopoulos	Greek
pbtsky	Russian
jbobgaquko	Japanese
ucofmeqsky	Russian
rfuyjjakis	Greek
vaoelli	Italian
vsksfuuopoulos	Greek
cnrini	Italian
vdxtmdfki	Japanese
earbqeyama	Japanese
dobuyzfton	English
iiigkztmman	English
qvpacelli	Italian
xjzvvejfev	Russian
tascehton	English
afriucci	Italian
wbhtmuki	Japanese
yjhmev	Russian
jbllhwyner	English
wroas	Greek
ahmwiqreini	Italian
sophqliwrio	Italian
gehnyama	Japanese
zotytqki	Japanese
celsjspelli	Italian
biftqmffton	English
eamnmcoakis	Greek
fglmtsakis	Greek
xtzxrhger	English
pmrqowpoakis	Greek
ynajdman	English
fbqzithini	Italian
tqxgucci	Italian
emaaov	Russian
jbuvwin	Russian
txxcwa	Japanese
jxsson	English
dagqzley	English
eurpeyama	Japanese
rnukvmjis	Greek
aktwuman	English
fhkhaspin	Russian
zdtirtmto	Japanese
bulmreaos	Greek
lhuaotnnyama	Japanese
skpeyyas	Greek
hzjpiov	Russian
hcvgpley	English
dabpppelli	Italian
plbman	English
ysyto	Japanese
wktxka	Russian
csgqpggoos	Greek
xfzjjer	English
rtayiki	Japanese
oxrki	Japanese
kcawton	English
cyytcki	Japanese
rylcpwhvsky	Russian
lcilmgios	Greek
rzlakis	Greek
lrxcxov	Russian
iiwztmano	Italian
vdmbuppson	English
ashzaev	Russian
driayelli	Italian
refczravis	Greek
myfyxxos	Greek
lrrmviuson	English
raemkftwa	Japanese
jwnwtgsky	Russian
xnegbman	English
jiaqqbopoulos	Greek
qxtko	Japanese
tfbyama	Japanese
tcrxwujhos	Greek
vezmin	Russian
krika	Russian
bkfzmhfini	Italian
umbjozvsky	Russian
khtton	English
pilwijin	Russian
vvyeugcin	Russian
mxctsev	Russian
inzpzmnman	English
hkwyko	Japanese
lhato	Japanese
xrjyama	Japanese
proagton	English
bkbmhbopoulos	Greek
nalbto	Japanese
cuuniatrakis	Greek
gsbka	Russian
bzxhov	Russian
eatikman	English
ylsowter	English
sufton	English
twrin	Russian
olpjev	Russian
usebkano	Italian
jwjkhqcos	Greek
urdakis	Greek
lulqgjas	Greek
mfftzvano	Italian
ptpson	English
nmahzndzrio	Italian
rnaoaer	English
eynmaeglyama	Japanese
laclgvaini	Italian
vxucki	Japanese
knbwa	Japanese
sblefias	Greek
hskjin	Russian
bwmixas	Greek
vzkton	English
kxoos	Greek
cyuqusrmopoulos	Greek
msgnkmdrelli	Italian
wtpiuley	English
ralvobto	Japanese
wppzxcriman	English
dsffatlnin	Russian
gewwley	English
zvegko	Japanese
ibfrewa	Japanese
mzomley	English
fifophtwis	Greek
rkuebehvman	English
diwacntsky	Russian
qijeman	English
vctsqeucci	Italian
pkkckiwksky	Russian
oknko	Japanese
cgrhdaaopoulos	Greek
gvefrio	Italian
poooman	English
nxqson	English
jxpazoyama	Japanese
lbhmzbkley	English
tqzjelli	Italian
xburio	Italian
bepiavunrio	Italian
fnonelsini	Italian
abhwki	Japanese
vluzzmzer	English
cjsoiktpko	Japanese
qgsley	English
srwitzciko	Japanese
bsxtkkos	Greek
wzvgenyrio	Italian
eexhucci	Italian
dedfwrucci	Italian
cvdktjrkis	Greek
awcelli	Italian
xwfegsko	Japanese
jfufkmrio	Italian
pcqyqqeeis	Greek
urupbkvko	Japanese
mqbrio	Italian
gwxisulmev	Russian
strimayvwa	Japanese
votisyopoulos	Greek
rhatoegmson	English
bsencmmsky	Russian
nklev	Russian
qnikpvqmwa	Japanese
pldfirio	Italian
aabmqki	Japanese
zznzqejini	Italian
nmlano	Italian
efiano	Italian
yqsucci	Italian
aezggko	Japanese
naqyhkpyama	Japanese
ahngbtev	Russian
gqunini	Italian
zwkson	English
xrhatyios	Greek
vsasyton	English
ptpspeiev	Russian
idglmtiley	English
kboglin	Russian
qaskpto	Japanese
vaksuakis	Greek
vnafka	Russian
euzbzelli	Italian
qtyekka	Russian
aogjebhini	Italian
ovopjrnoas	Greek
dvjcqopoulos	Greek
qxfgaqqyelli	Italian
zuqmwakis	Greek
snfelli	Italian
naxuer	English
wtyifoopoulos	Greek
qgdogyama	Japanese
fsgvuvyama	Japanese
zqzini	Italian
qejyemlwa	Japanese
ntrsaopoulos	Greek
eoxeman	English
otqko	Japanese
fhpvka	Russian
wzyin	Russian
zwruurio	Italian
rizooskwev	Russian
zonpkkgska	Russian
rtvboxgin	Russian
lscas	Greek
brsjlqtki	Japanese
rgqirqton	English
qaeaki	Japanese
ehski	Japanese
duzvka	Russian
kxcrzrdeka	Russian
umuzydqis	Greek
pammwytbov	Russian
sehpyeka	Russian
mrthis	Greek
qvnvjtobelli	Italian
npkrio	Italian
nqzxhgkas	Greek
zpoto	Japanese
zvgdev	Russian
ubvykrio	Italian
eucqpka	Russian
xhqiwiibas	Greek
rgdcjcjrio	Italian
wdyehuzkov	Russian
rodkuyton	English
cxbsuooakis	Greek
behujzywa	Japanese
qjinpsano	Italian
ynxnev	Russian
ngeka	Russian
gypqvgini	Italian
plowftwelli	Italian
dqmrto	Japanese
sckrev	Russian
fhhfjcmxano	Italian
luxirhsin	Russian
ogjwa	Japanese
wimfxdwa	Japanese
rjucuopoulos	Greek
tdncoakaelli	Italian
qvdton	English
cujdhzyas	Greek
pmwbwsirelli	Italian
jaxeszto	Japanese
jvuhgyos	Greek
ulxasxley	English
fdrgnmooyama	Japanese
mnnncaekopoulos	Greek
fzbezman	English
whitsrbcman	English
rhnpltyama	Japanese
otckeuev	Russian
dijatfelli	Italian
cojmlton	English
zmbducci	Italian
pyemto	Japanese
szylxumka	Russian
syfufrio	Italian
izcjtbyama	Japanese
kafxzkkson	English
yjvirton	English
frrhko	Japanese
pyhhcev	Russian
mxxwcano	Italian
sgelcyama	Japanese
zsoqqoskelli	Italian
wajaka	Russian
hopunrio	Italian
gbwqzlqov	Russian
xwrin	Russian
jgsson	English
cihrio	Italian
nfudzapko	Japanese
odbtvmuka	Russian
jekyobrio	Italian
aensvghzos	Greek
fwxgario	Italian
fgbsky	Russian
kuwkwaas	Greek
jxdder	English
mnpson	English
cikxska	Russian
dmnman	English
qeeeeibber	English
efvfblmman	English
vxtov	Russian
ygika	Russian
hsdgelli	Italian
fqmdzman	English
xtikton	English
egjfqrio	Italian
tonzaelli	Italian
qnngifxini	Italian
hnyouopoulos	Greek
vsruuer	English
phlmyckman	English
lkscipki	Japanese
zhuqbley	English
jdipzlto	Japanese
swlfjoer	English
xkvhkgko	Japanese
wwneyuysakis	Greek
hejgwympucci	Italian
dkpcfton	English
xurhwa	Japanese
vjnrano	Italian
nhvsanzdopoulos	Greek
jspsis	Greek
yyrzvcnos	Greek
vqcdrio	Italian
gwocahapis	Greek
mbpwto	Japanese
irtin	Russian
waremxiko	Japanese
edjton	English
yjzyomfer	English
xsufrio	Italian
ymggtini	Italian
xszswa	Japanese
msiqov	Russian
unwmev	Russian
ctnovaopoulos	Greek
gkhtos	Greek
mdfev	Russian
dmyis	Greek
ixsbyycis	Greek
iigpton	English
zgvirzdjyama	Japanese
zwicxbcopoulos	Greek
gbcircdki	Japanese
suwsvov	Russian
jufov	Russian
rnndmrbson	English
bhjedygas	Greek
kjriebgkis	Greek
bwpsvdin	Russian
grmos	Greek
zpdwcin	Russian
ezwdka	Russian
ejoini	Italian
rzucjcdman	English
ujkepwos	Greek
npqlopoulos	Greek
ngtchko	Japanese
upjka	Russian
mdzsjfhusky	Russian
jbcwhov	Russian
kbntrio	Italian
cnrilkman	English
yupxano	Italian
eulev	Russian
zcwosrtwko	Japanese
qlnmtjqucci	Italian
baldakis	Greek
olvmglano	Italian
efouxos	Greek
mmeywa	Japanese
aimapyama	Japanese
juiov	Russian
mquton	English
bzwqoson	English
unnka	Russian
vizos	Greek
reapki	Japanese
qxdder	English
hereman	English
ejaripkman	English
ltstas	Greek
icbka	Russian
tzdhlzini	Italian
lvayev	Russian
yoefyley	English
aznjos	Greek
rbtyoqelli	Italian
racaev	Russian
jwkhjctev	Russian
yduijprton	English
xuerbto	Japanese
qvrthamhev	Russian
uwavhorko	Japanese
edhvtxwoev	Russian
mtsakkrker	English
ssjwyyama	Japanese
fsxanakis	Greek
ubwjleqko	Japanese
amcxbmas	Greek
hhoyilki	Japanese
mkein	Russian
hnvko	Japanese
srbelsky	Russian
igpxmttsky	Russian
jijoypis	Greek
rjvelli	Italian
eifgjqayson	English
oweano	Italian
kkhmtdkrev	Russian
jsamfpucci	Italian
fifwa	Japanese
hygto	Japanese
zkvtjlfman	English
urzeqin	Russian
iaeley	English
fwttcoto	Japanese
jfteeaev	Russian
oryfdlsky	Russian
mmtgopoulos	Greek
helybgov	Russian
fqbjrylson	English
bndvley	English
shusky	Russian
thptpson	English
abuos	Greek
sukndmefer	English
wviwpcqxwa	Japanese
jaxostzelli	Italian
jzyer	English
xhcmton	English
ycjkmjowa	Japanese
azxdtjer	English
twdcvopnton	English
blfvpki	Japanese
azsfka	Russian
ukprbnvcka	Russian
ehcvov	Russian
urvoamki	Japanese
kheeto	Japanese
rlsto	Japanese
muqxev	Russian
nhpccas	Greek
jgabaxhton	English
syrselli	Italian
wcgeinltley	English
tgepyrwa	Japanese
vrgzvpin	Russian
ckgqebdini	Italian
amzlfwnmano	Italian
ozhlczman	English
iklhto	Japanese
vmkymko	Japanese
iqoqjski	Japanese
izsjer	English
jnusky	Russian
nseucci	Italian
mrkdeyama	Japanese
yonwki	Japanese
hxkwatoley	English
vieceley	English
nzvlasky	Russian
jporson	English
pxsoeano	Italian
jwuboagsky	Russian
ecjorveis	Greek
uxewbser	English
wmprio	Italian
mgnto	Japanese
ngadcezman	English
xvqev	Russian
emiyris	Greek
novston	English
fwrtmpxov	Russian
akuviter	English
earlnisyama	Japanese
eitlov	Russian
lbuaos	Greek
jmdplka	Russian
bgqxqsuov	Russian
ucbjbano	Italian
lmmley	English
vgkelli	Italian
udiqugpjopoulos	Greek
qbgbtini	Italian
qkmjodin	Russian
ibctbeoyama	Japanese
qwruwgpyama	Japanese
dlqki	Japanese
ndcsspmki	Japanese
xwqgvgfrio	Italian
bxkakrsky	Russian
ilurini	Italian
nkoweakis	Greek
lhhsucci	Italian
jfmmis	Greek
ywpkrbov	Russian
innrptgini	Italian
ezqer	English
ofpyton	English
rzuhikcwa	Japanese
keqlev	Russian
hazko	Japanese
arspto	Japanese
oyhrwfpzin	Russian
xyddyqwa	Japanese
ewxpuley	English
aytbyama	Japanese
ecbto	Japanese
gjvjrio	Italian
blxvpwvoton	English
zwndvssin	Russian
lwtnlyin	Russian
njbttxki	Japanese
gjyios	Greek
wlefjevin	Russian
yotgelli	Italian
scyer	English
waoalwjton	English
bydkpzley	English
kbxov	Russian
mwein	Russian
qbein	Russian
swgviokucci	Italian
ghkjqqwto	Japanese
ctfdjsrio	Italian
cimhwqnki	Japanese
hzeagcpwelli	Italian
leyqejki	Japanese
isfxpis	Greek
bzbelli	Italian
mvbcjvxin	Russian
csaryev	Russian
epdmelli	Italian
wxghknugin	Russian
ygzacbbxos	Greek
qtsis	Greek
oqdxazjka	Russian
quhkev	Russian
rtyftov	Russian
hbiwhuonopoulos	Greek
ynmfka	Russian
zzceevuin	Russian
lysas	Greek
iyoalwhcyama	Japanese
vrgvysky	Russian
npgtotqev	Russian
rsder	English
nthpnxluson	English
zpnpwdka	Russian
mevqrzto	Japanese
nrqvwa	Japanese
xumsky	Russian
fsffnnki	Japanese
wqaswwgki	Japanese
mkfto	Japanese
tvwrtaojakis	Greek
zksros	Greek
ktppoman	English
tpmjako	Japanese
lxrakacer	English
dymkprka	Russian
ceslmlzson	English
ocudjqnos	Greek
lybawtfiev	Russian
ufqorpluopoulos	Greek
huayesgaov	Russian
ekuacuqmov	Russian
fsyamko	Japanese
ffhgrio	Italian
duraopoulos	Greek
azpman	English
zizfin	Russian
iwzski	Japanese
pzxuano	Italian
zkpzwczuev	Russian
vtlnvyrio	Italian
xmrrio	Italian
ujilher	English
cimunrrvrio	Italian
gvxiqgzano	Italian
hvlurnufopoulos	Greek
nmjqwa	Japanese
avzoton	English
paqtjhfrio	Italian
gvuijhxopoulos	Greek
krblayxzas	Greek
lxbucci	Italian
imofxabton	English
fytygley	English
oohxpeskev	Russian
uvahracnelli	Italian
ldlbvewini	Italian
avfrdano	Italian
hceoter	English
yptyer	English
zxxson	English
hvlsov	Russian
mlfoano	Italian
nvmfzvlson	English
lphqgrwev	Russian
kciuyrio	Italian
ucshkdcin	Russian
lkyvhrio	Italian
epfrdnin	Russian
oimdman	English
kplnxxyxsky	Russian
dfynako	Japanese
dqzuomfini	Italian
bnshctnis	Greek
ttkcin	Russian
jkbwa	Japanese
reevwxnopoulos	Greek
zdfygizhley	English
bjqlcvjis	Greek
lthmev	Russian
verelli	Italian
hieton	English
omoftucci	Italian
wkjka	Russian
juigcqwgev	Russian
tlhzcbman	English
pdvudkos	Greek
vsdvki	Japanese
mzkzos	Greek
fqdnto	Japanese
xbxakis	Greek
tefdko	Japanese
msczas	Greek
vonyki	Japanese
leska	Russian
aoujltko	Japanese
gbiikov	Russian
aeyuin	Russian
rprtos	Greek
julbftkqton	English
bhuybiyama	Japanese
zginvwovas	Greek
crwxehznucci	Italian
bchakis	Greek
fcbykdman	English
mbdrjman	English
dhrley	English
zhfbyley	English
xcyvmqdxton	English
ahrsvvson	English
xmtaki	Japanese
wjupnpfos	Greek
lecev	Russian
paoov	Russian
irlzyama	Japanese
kdfgoaqas	Greek
ysyov	Russian
zujlias	Greek
petmlkmyama	Japanese
onpcis	Greek
xvzdwyko	Japanese
yenhslopoulos	Greek
xmymin	Russian
allpis	Greek
grqki	Japanese
fxeelli	Italian
mcjjzmmfrio	Italian
xgajyama	Japanese
nydvjfov	Russian
jqhducci	Italian
xngnipawa	Japanese
mrsmsko	Japanese
gmrko	Japanese
airman	English
tuhmxhwcwa	Japanese
xeywakis	Greek
ufpbmkthev	Russian
ibmsky	Russian
crois	Greek
fipdqgason	English
owsopoulos	Greek
kvoqtxka	Russian
pjstottini	Italian
edpdini	Italian
nzknlqxini	Italian
rvdancpis	Greek
hdngdfucci	Italian
lofxyki	Japanese
tjtngpka	Russian
csgakis	Greek
ssbmqfwbos	Greek
apcnplgzman	English
hzwgndsky	Russian
tqkisbov	Russian
tbhpvftlano	Italian
ykqhkwnelli	Italian
rydepixis	Greek
eekykdozas	Greek
wxfkrcuev	Russian
fdwfwgki	Japanese
wrmsky	Russian
ilidgxyakis	Greek
hdkmgini	Italian
ayzpakis	Greek
vxkytbuko	Japanese
vjlzsroewa	Japanese
xttfwdoin	Russian
uycnmley	English
ggtin	Russian
oapwedton	English
jawfjeufman	English
wtqelli	Italian
vhfxhnev	Russian
drdano	Italian
fjyrielli	Italian
wihzev	Russian
tjonlwcdka	Russian
ckniatzswa	Japanese
plgtrka	Russian
obkjsky	Russian
cvutbucci	Italian
cvycauman	English
ktifxsucci	Italian
ufhton	English
mnsvntfyto	Japanese
hhrmcakis	Greek
curelli	Italian
atzhzzjeas	Greek
amnvfley	English
nggzjley	English
hhigpldakis	Greek
tixbqnwa	Japanese
jhxrelli	Italian
erkkaoito	Japanese
slfucci	Italian
ltipuahakis	Greek
njkgktdki	Japanese
biodzko	Japanese
abysakis	Greek
erqogano	Italian
xtumvmqnrio	Italian
rtsioanyama	Japanese
uansbcitki	Japanese
aygka	Russian
odkmplnnano	Italian
kcrxqnavov	Russian
vjisxvto	Japanese
wgltuton	English
kaikyauas	Greek
wszhpkwa	Japanese
wxifka	Russian
pwrko	Japanese
zodjbman	English
vhrano	Italian
xfymjqyama	Japanese
qujsto	Japanese
bvmgkqlto	Japanese
caycyeorka	Russian
kcztugawa	Japanese
ewpolakis	Greek
bgmkneyama	Japanese
ngijvjguley	English
qytmxxelli	Italian
rcvman	English
lovnson	English
xbohdojiwa	Japanese
nfvnemto	Japanese
rkwbqtko	Japanese
pizpylakis	Greek
juhjqwkeucci	Italian
oxozano	Italian
pmonka	Russian
aieapki	Japanese
cjtolto	Japanese
ckyrio	Italian
ygbtsbzbson	English
xbznlopoulos	Greek
qehxjxikelli	Italian
uvnlhas	Greek
vennson	English
ioaka	Russian
bxhev	Russian
lncctwytakis	Greek
xmkccrdas	Greek
xoziopoulos	Greek
jxjki	Japanese
cquyunko	Japanese
aixoxsnmki	Japanese
wtaxas	Greek
mktslson	English
tciwfwhwis	Greek
fswfpnjaev	Russian
vhtrnfelli	Italian
blcgcka	Russian
bjpjohto	Japanese
cioxxqkis	Greek
jjeagkucci	Italian
daxvfelli	Italian
uhlcrxopoulos	Greek
ppjdgyama	Japanese
cqvgaman	English
lginykrini	Italian
tqyrano	Italian
dprtkktzley	English
qjwvzcfka	Russian
lzqdmki	Japanese
fgrgdshano	Italian
crwybxbis	Greek
imgas	Greek
tfjfdwtlley	English
hybsxdfcko	Japanese
pgjcini	Italian
mcghckulano	Italian
ckhson	English
zjjson	English
rcvwdbko	Japanese
trjvywa	Japanese
nxwnhxano	Italian
dzrxfucci	Italian
entakis	Greek
ebnjvini	Italian
zdandwxmopoulos	Greek
abyakis	Greek
viezson	English
enqeevcki	Japanese
mfuzmtsyrio	Italian
qguer	English
zwcxaalko	Japanese
vzuuer	English
yeruki	Japanese
gfeabuvoev	Russian
tpxeiis	Greek
detlcjas	Greek
zbkvqzuaman	English
azmbjros	Greek
ianzer	English
iozmwtano	Italian
saicuqxska	Russian
mwigbdrio	Italian
lnzehqrpucci	Italian
oxmlnwtakis	Greek
gmvson	English
eesacdzxto	Japanese
aipsivopoulos	Greek
tagqagkov	Russian
szykxhrelli	Italian
jcswyos	Greek
zsxblhano	Italian
rhslyama	Japanese
gubskxto	Japanese
xmpazriqley	English
qxynzkmwto	Japanese
lyvvakis	Greek
qfwrson	English
gehlgbnka	Russian
nrxjvopoulos	Greek
upqatmwa	Japanese
hpixiskucci	Italian
echluto	Japanese
klvzwkka	Russian
wtpirwoer	English
cwujqmvfin	Russian
ydxudko	Japanese
nikhitopoulos	Greek
cylyurio	Italian
tmoucci	Italian
hxazbsis	Greek
qfbdmzgbini	Italian
puuefieelli	Italian
yrzxgas	Greek
pmnros	Greek
qyinuwbcakis	Greek
azggjka	Russian
khosky	Russian
mmxpdlkano	Italian
alhsemini	Italian
pixmuwis	Greek
bukxto	Japanese
zjtscdtwto	Japanese
noxuvis	Greek
xbfclas	Greek
havpokkley	English
fmfton	English
tlmpucci	Italian
xmaorucci	Italian
kcvzswka	Russian
qcopllcsky	Russian
wijdzjtyis	Greek
vdniucci	Italian
qyvyis	Greek
kvspioonas	Greek
sbpalwa	Japanese
tiuzwgujelli	Italian
pvpdknzko	Japanese
xasiley	English
mwhjdlsky	Russian
oodbvbdini	Italian
ioohyjtielli	Italian
iwrpefllin	Russian
midhkas	Greek
dmrkuwa	Japanese
tvketo	Japanese
lllrayvley	English
xtjplqini	Italian
bezqyiyama	Japanese
fhgxxuer	English
jaoyama	Japanese
zsouwdano	Italian
spxzzwhjyama	Japanese
wkskbakis	Greek
jlwymbson	English
gtmyama	Japanese
oltov	Russian
oxbin	Russian
zuisbprki	Japanese
qkkvos	Greek
edxzlszyto	Japanese
nomvhlgopoulos	Greek
lvzlko	Japanese
bpboeeakis	Greek
iycgis	Greek
ygtini	Italian
gbtojsky	Russian
jthnmvhkki	Japanese
oycwiqos	Greek
yvavbovxman	English
nlremaqfano	Italian
nhxpzsiwson	English
yqmnsdcman	English
zzfcer	English
fzmcdley	English
rszekztjki	Japanese
iuuimlelli	Italian
vkijcson	English
zywakis	Greek
gmoelli	Italian
vkeos	Greek
uurdwsgton	English
jydryipyama	Japanese
vefaciucci	Italian
hkibson	English
ofrgin	Russian
aqpyin	Russian
pbxsanrio	Italian
rhyki	Japanese
xtlaki	Japanese
pwcunfdpto	Japanese
rqqmrov	Russian
qmselli	Italian
vfmjev	Russian
tnojdko	Japanese
mbkis	Greek
amzizzsbakis	Greek
ahjekvdwko	Japanese
bdrcxlrsyama	Japanese
resmoaton	English
dkhcucci	Italian
mxeykfmzson	English
dnsxson	English
qolziqaeakis	Greek
ylrhley	English
vtucini	Italian
ohzkcki	Japanese
imsgyano	Italian
fxcev	Russian
erhsky	Russian
klquswpka	Russian
hkzakis	Greek
ppcki	Japanese
blnqin	Russian
jceiwmaev	Russian
irzhyuka	Russian
ghomras	Greek
oymoovnov	Russian
ihjkuwka	Russian
uvhcuypyto	Japanese
hfisin	Russian
ypikdyama	Japanese
irbsjwoelli	Italian
clmakjfin	Russian
tyslswev	Russian
dddbpski	Japanese
oljvxwa	Japanese
oeqszki	Japanese
mvsger	English
ivaygakis	Greek
qivmqlxin	Russian
mxsxtfin	Russian
qenzka	Russian
tyoki	Japanese
tlobyuto	Japanese
nemhposis	Greek
vzcyama	Japanese
lderko	Japanese
fvzbki	Japanese
fjgfhgvyis	Greek
gtshev	Russian
azmwamucci	Italian
hvamtlueelli	Italian
rmkyetano	Italian
qkhpov	Russian
iiqrkjka	Russian
hddsuko	Japanese
flljeka	Russian
honyjsky	Russian
zaprnucci	Italian
ormavfbhakis	Greek
dhcpson	English
wkrmngska	Russian
zpsqypfley	English
zwcito	Japanese
lznfsdpucci	Italian
jdnahto	Japanese
rqapaakson	English
qpjkov	Russian
evfson	English
pljlicmika	Russian
evwcbimki	Japanese
kuxayder	English
vvsoiiman	English
xmbpka	Russian
xrzggini	Italian
qpehwakis	Greek
rwuanbson	English
oteherio	Italian
ixvko	Japanese
wdtuoadano	Italian
dsnptpveov	Russian
lcseos	Greek
erxxlehsky	Russian
oaisugyton	English
qfsdkakis	Greek
zdcngucci	Italian
jtfyama	Japanese
ojwdzwa	Japanese
rzohston	English
eltcqrman	English
juszin	Russian
yunwki	Japanese
yijgwa	Japanese
kjtoqpftton	English
dkmywjelli	Italian
ubftsbyzis	Greek
uaujejpucci	Italian
uaxyama	Japanese
atcnwas	Greek
pnejto	Japanese
wyweelwa	Japanese
bhnzakis	Greek
tycer	English
vkein	Russian
wdyton	English
mjciton	English
szaaucucci	Italian
tzhgano	Italian
xiozjffakis	Greek
hzyuyktnopoulos	Greek
zclhtato	Japanese
yfxjoxman	English
abxgeko	Japanese
sbwos	Greek
oncujwa	Japanese
qphxwker	English
bwjfuhdmucci	Italian
exwxbxnki	Japanese
shtgjelli	Italian
saikgxakis	Greek
lfqprwhkton	English
zqdhman	English
hikhuvsky	Russian
hnjdsky	Russian
ypiauley	English
gwofbis	Greek
bkcmbman	English
kdapson	English
krpbzucci	Italian
wbieeuvvano	Italian
jccstfano	Italian
ekhucci	Italian
yqcschev	Russian
wxhxwev	Russian
yctwpos	Greek
pyklpdmnelli	Italian
uueinhaton	English
necvvrvlin	Russian
eayaoton	English
bjebkka	Russian
mqzlvuntopoulos	Greek
jgvto	Japanese
qbxko	Japanese
bcjin	Russian
xgtsky	Russian
qqrdrtgyama	Japanese
vdmhrqini	Italian
pwrxlcqwa	Japanese
blubvsmwa	Japanese
ryfmpfqyama	Japanese
ewpfaxka	Russian
vjoeugogev	Russian
aoqhxyama	Japanese
bymtopoulos	Greek
suslduias	Greek
rgnocimrio	Italian
bnmqqxnrio	Italian
rkyrio	Italian
njlin	Russian
vtzlmsky	Russian
ycqbrio	Italian
eaxbelqer	English
yzghyki	Japanese
zhavgdki	Japanese
rpdszfndwa	Japanese
pveadeiini	Italian
jkkavson	English
sbqxxini	Italian
rgspmuois	Greek
pejmdmgos	Greek
hqhyvson	English
scjsky	Russian
tjthini	Italian
widossunwa	Japanese
ymeqtpelli	Italian
qtzrio	Italian
keoyer	English
afeto	Japanese
hjblin	Russian
dflcvlko	Japanese
bidqufyqos	Greek
nmnini	Italian
fgsis	Greek
rjyiputyama	Japanese
mzgnckeopoulos	Greek
krzzjjjto	Japanese
fziwka	Russian
rrmgxson	English
hocjlbman	English
rbwsky	Russian
muszdizdko	Japanese
snamcaioson	English
xddszztis	Greek
vvtejxrio	Italian
rvygjcbto	Japanese
icgini	Italian
druos	Greek
kcwelli	Italian
udosvson	English
obqlnini	Italian
izbzmodjakis	Greek
gcagdizwa	Japanese
kpeyeki	Japanese
ptizboxiini	Italian
oiitley	English
oathhtdis	Greek
tjcfumjcyama	Japanese
hfnki	Japanese
cwurini	Italian
mhcvbcini	Italian
mukjnzdis	Greek
mbmjini	Italian
ojqmoka	Russian
myuusqsano	Italian
qcoauis	Greek
aboki	Japanese
opysky	Russian
sjtgzto	Japanese
qddcodka	Russian
bityama	Japanese
ijjson	English
snoihelli	Italian
vqjvsxnwer	English
hsdpini	Italian
hlhaybjtley	English
mumlis	Greek
dxtpuohdki	Japanese
jynweiqton	English
zxzrer	English
kvhtepopoulos	Greek
vciwchas	Greek
zdypakis	Greek
bnallryama	Japanese
koteyama	Japanese
ekamwzka	Russian
glyimjmis	Greek
wtoadjvas	Greek
ahtwhielli	Italian
dxrmmxsewa	Japanese
tubkini	Italian
mbabos	Greek
yxbckncnov	Russian
griziyakis	Greek
echos	Greek
xrqeuygqev	Russian
tbyvvwrki	Japanese
gvgcyama	Japanese
iqdpvouhrio	Italian
xncteelli	Italian
reeangyov	Russian
mjdpmcuuis	Greek
gniyov	Russian
hnqgkutko	Japanese
oniahesky	Russian
cwsxhvfkis	Greek
uzmzopoulos	Greek
mthoka	Russian
tskffkfucci	Italian
ijvqito	Japanese
xrnqddcjto	Japanese
nialey	English
krpopoulos	Greek
kwltvov	Russian
fypqptbfwa	Japanese
weaas	Greek
ofdnto	Japanese
xagegkko	Japanese
rzaelli	Italian
lvtssopoulos	Greek
xozsto	Japanese
pskylos	Greek
eixoivccos	Greek
gmoagwqnto	Japanese
uonddfano	Italian
xfggaos	Greek
lmhos	Greek
esfuiureakis	Greek
fzdbki	Japanese
gcfuohwopoulos	Greek
rlefario	Italian
ctoson	English
erpivos	Greek
wfptwnygki	Japanese
ftxano	Italian
cvwaaano	Italian
qdtev	Russian
weenfis	Greek
gnain	Russian
hkbeley	English
wgver	English
igokzgsdton	English
ratdopoulos	Greek
dnznko	Japanese
pxvjahgyama	Japanese
iicamini	Italian
isoaavko	Japanese
zxkraini	Italian
udpnjesnelli	Italian
sejos	Greek
akautin	Russian
wndxxygos	Greek
wklfelli	Italian
vzrber	English
gououjhas	Greek
bwwjpmfkelli	Italian
bydcdas	Greek
kqvnfton	English
rrrfmbhcki	Japanese
sahailzucci	Italian
wysopoulos	Greek
nczjeftsky	Russian
kwyjvxltelli	Italian
xzlsnin	Russian
pttcdvelli	Italian
zrhawjywa	Japanese
eoikyvyama	Japanese
arslqsin	Russian
lvfsky	Russian
gmwqka	Russian
aqgwa	Japanese
vxcevqko	Japanese
txhavpiopoulos	Greek
dxhxstyuin	Russian
eodukwmos	Greek
qvpxley	English
leqlxurtakis	Greek
udryyiyto	Japanese
mwhbwsos	Greek
hpsjtska	Russian
kovuvano	Italian
dbomselli	Italian
muykwa	Japanese
yolsdton	English
ihksuqgtka	Russian
uwsxboztucci	Italian
qkoqyto	Japanese
nvzrcki	Japanese
jgjvbpwto	Japanese
uvdzvoin	Russian
vugwa	Japanese
uapqrgmssky	Russian
gwwqer	English
hgnucci	Italian
kerkvybis	Greek
yevton	English
fohkano	Italian
toeitov	Russian
ehipton	English
nztkbka	Russian
lkllwobeson	English
dpicgnev	Russian
sizpzrio	Italian
drshka	Russian
epvxyzanev	Russian
xmdefeka	Russian
wualmjjnley	English
vailano	Italian
skbenelli	Italian
apppyrucci	Italian
hueprio	Italian
xtbivnbson	English
wxhmakis	Greek
vensafvfto	Japanese
olkvamdin	Russian
nuoos	Greek
vdfbbsky	Russian
ijtbopoulos	Greek
pfdmfxcko	Japanese
hyvhsxucley	English
mzutedaer	English
pcfman	English
breto	Japanese
uooxas	Greek
ybkjtrer	English
rrozfrebki	Japanese
fwvqson	English
nsrbev	Russian
wnlqskelli	Italian
nasnwario	Italian
ewuikfano	Italian
orowwa	Japanese
rriaoako	Japanese
kpooybrio	Italian
tqqtin	Russian
jemqbztman	English
mvxcopoulos	Greek
oaaano	Italian
cuqnbkton	English
qazgcwuki	Japanese
pslucto	Japanese
qgdfyyito	Japanese
lhlvvicmos	Greek
tctrvirov	Russian
awdpawakis	Greek
dlfbpoyama	Japanese
jbjhhnka	Russian
xotmois	Greek
cvbkccini	Italian
bvpos	Greek
rxlaxfov	Russian
elvano	Italian
fvyuhwakis	Greek
cavman	English
ltztpiopoulos	Greek
htnktxoxano	Italian
lemvucci	Italian
ufbjcmjdano	Italian
jbzzvlson	English
oytyman	English
zymxsyko	Japanese
rdxvmyyama	Japanese
kpyczopoulos	Greek
vbzlqjtrio	Italian
ciistbqos	Greek
qmfjxson	English
iikastucci	Italian
gfilyhas	Greek
xsdddcson	English
zwcriopoulos	Greek
trvxkthto	Japanese
lsndka	Russian
voxman	English
raybeevnano	Italian
tpveaer	English
rfsqpucci	Italian
tecyzjpvev	Russian
riojmajfakis	Greek
dpxrivton	English
incton	English
krbzilman	English
nontakis	Greek
tosrqopkas	Greek
qioyjini	Italian
adtexley	English
awktnfton	English
cwsgimhqucci	Italian
eiqev	Russian
thnxzvano	Italian
clnko	Japanese
wewhyama	Japanese
vnkko	Japanese
akhdmbeelli	Italian
jhhbgovfki	Japanese
nuufjjoev	Russian
czzdto	Japanese
rwapka	Russian
pryzbmnson	English
jltqkqmmelli	Italian
kwjcqaelli	Italian
qfkecfvqakis	Greek
sbktimko	Japanese
yjfrqfwakis	Greek
bkebhcelli	Italian
rroczxyman	English
fagnmqnjman	English
prmenrwvwa	Japanese
eqoxmaman	English
qpoley	English
ocxanman	English
hiuuas	Greek
hknfguelli	Italian
uwybbiwa	Japanese
qlwspman	English
yohxsky	Russian
lzoajwfer	English
ekkkjnqtsky	Russian
oubjddopoulos	Greek
rclzsnuwa	Japanese
ohqmzkmtyama	Japanese
qvixvrio	Italian
hgfwftcwto	Japanese
tklrowoini	Italian
nfhvtikska	Russian
nibprio	Italian
rtkgbcewov	Russian
sqawson	English
qpcymerhman	English
rtbkryini	Italian
vadlggoev	Russian
moaeuton	English
qyocwa	Japanese
tnvtlki	Japanese
jlpksktsas	Greek
kkuelli	Italian
swucki	Japanese
qljcrsky	Russian
fwkexas	Greek
ovyley	English
yycmas	Greek
tuwsky	Russian
lpjwjev	Russian
zgbman	English
mytiogaqko	Japanese
bgxlvman	English
czfxjjaxman	English
ynhjos	Greek
cfzwcakis	Greek
wvflpka	Russian
sbwajptano	Italian
zuheev	Russian
acrtczini	Italian
xxhizley	English
cggtyvucci	Italian
fonrncfpto	Japanese
dydeini	Italian
cwwgqchson	English
sjrbfka	Russian
brruqwcakis	Greek
njzlfgdsyama	Japanese
bqecvggas	Greek
xwgdoehki	Japanese
bjwwcpyama	Japanese
gwrsctdqin	Russian
kadelli	Italian
ayhier	English
napciakis	Greek
lbwpolto	Japanese
uoehcmyxelli	Italian
agvpuqov	Russian
vxybkywyin	Russian
ystmsky	Russian
moaaltka	Russian
tmmvthelli	Italian
wobaton	English
vkqazaspov	Russian
brnghfgjelli	Italian
krypjjka	Russian
gtufhokakis	Greek
pfeqkrwsky	Russian
kxilkdgucci	Italian
nzagjqfsky	Russian
rrgrwpto	Japanese
ugehrabwa	Japanese
iolqjnton	English
nxpwidmelli	Italian
ebmto	Japanese
klfsopin	Russian
ilqev	Russian
ddxyiizov	Russian
frdwjwelli	Italian
cnrki	Japanese
jmasky	Russian
cqtto	Japanese
xazkkkwuwa	Japanese
ifxmqto	Japanese
yiyhpocwa	Japanese
jzviev	Russian
slvnzrio	Italian
hacov	Russian
ueepyeis	Greek
zspiveos	Greek
zgmzqhrlyama	Japanese
vuoazakis	Greek
aywtsson	English
lbrdcgnzwa	Japanese
iquika	Russian
xpobini	Italian
zpskko	Japanese
djzftlijucci	Italian
skjecxki	Japanese
epkfqaini	Italian
xwcuogev	Russian
svzjwyano	Italian
hkvdopoulos	Greek
hfnixqtton	English
vbbcoaorov	Russian
wtjuukomson	English
iyser	English
cwjfuis	Greek
lyezrgugrio	Italian
rzpwlmvpley	English
vgbis	Greek
miuowki	Japanese
kqrsky	Russian
obvqztiov	Russian
xsddndov	Russian
iimwucini	Italian
hbysolzas	Greek
yjpgxyvqley	English
fhpxvpjrrio	Italian
bprko	Japanese
ekhfkdfcka	Russian
fyfmpssov	Russian
vmnxaeakis	Greek
xgrgswa	Japanese
njmko	Japanese
ywason	English
xpayxsaoson	English
qybquqton	English
hfbpzzyyama	Japanese
hiqitevopoulos	Greek
jronvftnwa	Japanese
zjvizkin	Russian
enpmlvano	Italian
qfqdosiin	Russian
lazbgjkto	Japanese
fnfton	English
bgexopoulos	Greek
flohhini	Italian
yboyyiyyos	Greek
kcnqwa	Japanese
eiomxpldman	English
rgpyussaini	Italian
mxynucci	Italian
epnhman	English
erlwrio	Italian
hoezhpvman	English
ysgdbman	English
pyxwwbarley	English
ugibelli	Italian
iggto	Japanese
duurzqgrer	English
uycelurio	Italian
aiohodsqas	Greek
nsvmrain	Russian
wljjxelli	Italian
pvwrzsky	Russian
vfnjakgto	Japanese
utnqko	Japanese
gixeqrgucci	Italian
tottin	Russian
vgcwas	Greek
fdtqev	Russian
nlzlycvvos	Greek
amnnxley	English
vybmuohjki	Japanese
cjssvrki	Japanese
rslxley	English
ahqkfjepin	Russian
dklston	English
ojgsvnhtley	English
ktjagrsano	Italian
jnlnyvulelli	Italian
bqpgbbsky	Russian
vexin	Russian
vmhvxfer	English
zogxwffxto	Japanese
oisgtcnrio	Italian
sdbka	Russian
rqnmxov	Russian
xenjwa	Japanese
suwgvpqwa	Japanese
uicpnos	Greek
atgpdnjyas	Greek
ajlopoulos	Greek
innsjipzman	English
oyrbxyzer	English
savkmnlson	English
orzjopoulos	Greek
sqyko	Japanese
oihias	Greek
mqktgqbin	Russian
kbehbqsuley	English
mztufwa	Japanese
yhliqton	English
fdfdvas	Greek
hqoyama	Japanese
rbgkjntev	Russian
ajszbgki	Japanese
oionxko	Japanese
xcncffdzev	Russian
xsvmev	Russian
znwqwwcucci	Italian
zjdev	Russian
hgglernopoulos	Greek
hqkev	Russian
fskin	Russian
adacfjzer	English
rclko	Japanese
xuzctjka	Russian
dgmuzxlos	Greek
dsdvxucci	Italian
nrocqnzton	English
araujtsky	Russian
wfyras	Greek
wdtnceka	Russian
ecyger	English
febsyas	Greek
bgpvcpplka	Russian
mewoiakis	Greek
mdcwfnsky	Russian
hbmslcnkin	Russian
ddrnov	Russian
cdvxevwsky	Russian
hgbfklsakis	Greek
xebnzehyama	Japanese
ktnrvwqwucci	Italian
swmov	Russian
rbjlalis	Greek
eybsky	Russian
qdmwa	Japanese
ryaiixzzin	Russian
wcwtpdiov	Russian
inskas	Greek
lamasvzano	Italian
newopoulos	Greek
mntrhucci	Italian
subpiis	Greek
cjevtos	Greek
louonfkelli	Italian
omymtos	Greek
gbdmjopoulos	Greek
umdpjvwton	English
saezvopoulos	Greek
zomcdymton	English
rmnaygjtley	English
zmrtuton	English
bdmlmfpxki	Japanese
fclrio	Italian
cwekman	English
gkekrio	Italian
qkxka	Russian
tmcofos	Greek
kyeini	Italian
hkgycgxducci	Italian
nakttelli	Italian
eheexwwdini	Italian
esias	Greek
dziwuzcison	English
qhiwzgopoulos	Greek
yrewjbyto	Japanese
nqesky	Russian
ptsvka	Russian
duabzvsin	Russian
fnloqley	English
vklqki	Japanese
ylengwa	Japanese
regxypuis	Greek
jxfeuano	Italian
dcoqvley	English
akbhiklman	English
qfqpfaioopoulos	Greek
mmwbreko	Japanese
jkwwqoos	Greek
upkman	English
gwmrltgdev	Russian
edvubper	English
zihauov	Russian
cijleska	Russian
lwojito	Japanese
tztton	English
vlhsky	Russian
zsoftton	English
acaybxis	Greek
jjttrio	Italian
wrwlrwnuini	Italian
qcpqmbwis	Greek
sseptev	Russian
nhqepjley	English
gdffsky	Russian
kirboajton	English
djxxqgzmley	English
opxpiyama	Japanese
hmmki	Japanese
aavomwelli	Italian
edfzvurman	English
gqnrfprev	Russian
niwzto	Japanese
gajxas	Greek
sfvybmopoulos	Greek
irlto	Japanese
giuisky	Russian
zxisrcducci	Italian
ldeifdini	Italian
horvcpywyama	Japanese
wxhzmiuucci	Italian
wnxev	Russian
lxrzuas	Greek
fcthpakis	Greek
gynman	English
spfpmki	Japanese
ppplsglko	Japanese
gyjyama	Japanese
tcslhko	Japanese
urzjfnzin	Russian
gttaton	English
labyama	Japanese
htdev	Russian
ajjfxgnano	Italian
fycistayama	Japanese
qmdzmyioka	Russian
uzvtsov	Russian
hqvamoucci	Italian
ovhmofos	Greek
mdbzfygois	Greek
hvfblko	Japanese
sofiltpyama	Japanese
votgfrio	Italian
ddvwa	Japanese
tdovpguzelli	Italian
snqwa	Japanese
rwruvrnyama	Japanese
kvtpglqin	Russian
jgwgniiki	Japanese
mgepin	Russian
nzyltmzzwa	Japanese
ouxmmtiucci	Italian
xclluzelli	Italian
ikubwuelli	Italian
ylhrio	Italian
tuarwa	Japanese
mkhutikos	Greek
zlirbyton	English
lhris	Greek
rlmsgfxtson	English
tmjxqber	English
hogbziov	Russian
xmgelli	Italian
kdbelli	Italian
qhrouko	Japanese
gjmowa	Japanese
wzmnxyama	Japanese
epgzley	English
idktezos	Greek
cbcafopoulos	Greek
pzryama	Japanese
dmjqiakis	Greek
supgqgto	Japanese
ciigkoev	Russian
pqsgkazlelli	Italian
fyoyama	Japanese
pknypbpyama	Japanese
dftfhxmdis	Greek
egpopoulos	Greek
tusqjini	Italian
pnqoson	English
qyapscybrio	Italian
aniini	Italian
oqgko	Japanese
qxiqgzini	Italian
qylogton	English
jwvajiterio	Italian
btagdorley	English
zmzihxcnton	English
xtqiias	Greek
rvskxsgov	Russian
ubouer	English
wkeki	Japanese
ybdxlfgos	Greek
tvtmmghson	English
hlmlas	Greek
aotuka	Russian
izzbzsky	Russian
fadeko	Japanese
crkaini	Italian
gcvrelli	Italian
mqezbjqdov	Russian
bljqas	Greek
qloyki	Japanese
gszqxeas	Greek
vkhqdlcrelli	Italian
vgyqto	Japanese
esldqwa	Japanese
luovnley	English
xckksbhbakis	Greek
nxxtkjika	Russian
dvzkawwa	Japanese
jsxdwkxos	Greek
euijnwjos	Greek
aontler	English
wzyglkqucci	Italian
qywsky	Russian
oykjoyton	English
ilsfljyama	Japanese
qoejley	English
tptbapson	English
ltjrjucci	Italian
ixdnneto	Japanese
znvpdis	Greek
shkafrio	Italian
itxzamwa	Japanese
yepein	Russian
gzcjlyama	Japanese
dpubber	English
krhzjano	Italian
klnzfdnucci	Italian
lzvpton	English
brztlyawa	Japanese
aqnos	Greek
cpclano	Italian
kyfcuwski	Japanese
hmrmos	Greek
hcvvnbqsakis	Greek
luvacblas	Greek
tccdas	Greek
bfmjson	English
wgvvxhwsky	Russian
hpsbfais	Greek
uoqfucrakis	Greek
qjjoakis	Greek
yonmhxev	Russian
arhjqwcfer	English
ymnjpiexton	English
aiourelli	Italian
tnnhoter	English
vwropoulos	Greek
itsfjki	Japanese
vcjimtis	Greek
wkhczkkopoulos	Greek
uegtiyama	Japanese
mzzsyarston	English
mmnvzqcini	Italian
eszzis	Greek
yuuueimrton	English
bhogman	English
ryibmvwcto	Japanese
pjwqkpakis	Greek
izker	English
vzkvyoopoulos	Greek
qmrvabano	Italian
xemrio	Italian
uitigki	Japanese
oblnson	English
lgizifini	Italian
ecvqnin	Russian
wdlebhano	Italian
scsqlvvaev	Russian
udhhkko	Japanese
rcuano	Italian
fwsqton	English
wgfpvsyama	Japanese
ggrdini	Italian
xzqko	Japanese
pbbleetcka	Russian
ouyjsrio	Italian
takepawelli	Italian
tnddzjgano	Italian
bjauopoulos	Greek
xxldhbncyama	Japanese
edmrakis	Greek
kzgodwa	Japanese
ebjhyama	Japanese
ojhzos	Greek
nnlmbfman	English
cnlkqaton	English
okkketon	English
bvhmki	Japanese
oxkdov	Russian
xvnrpov	Russian
akocycfyama	Japanese
mowakis	Greek
hlzzman	English
ywhaas	Greek
jxswkcnano	Italian
osjto	Japanese
wqhson	English
fmvinley	English
vkxdsaexini	Italian
yucano	Italian
qbykdbtelli	Italian
mylxhman	English
yhakki	Japanese
jgowbasrano	Italian
yihoobsky	Russian
axiobdsky	Russian
wtfrvzhgucci	Italian
ourwa	Japanese
domtolbwa	Japanese
pxhakis	Greek
ywcson	English
lscymtyrelli	Italian
ucpsgmjuton	English
twixjbmev	Russian
exksgano	Italian
vpmwa	Japanese
imfapruev	Russian
uxfoyama	Japanese
fnayeuvmos	Greek
nqaxdatsky	Russian
sucko	Japanese
arcuobbelli	Italian
wmvfqaer	English
oppzbcas	Greek
ewmqedos	Greek
nuuyxakis	Greek
napogwa	Japanese
mwzsvos	Greek
ebldis	Greek
hxsxvoano	Italian
tflbbpldopoulos	Greek
izxqnupgwa	Japanese
rexos	Greek
piqojpotto	Japanese
tvvkurjelli	Italian
lmtsakis	Greek
fleyama	Japanese
gbwminuka	Russian
mzpdka	Russian
nssgglhov	Russian
chyrprgber	English
eqzxxzpwa	Japanese
kkfnman	English
tviyka	Russian
pqddfko	Japanese
svsgjxer	English
hsfzeeka	Russian
ouoley	English
azhsuwa	Japanese
yuubkwa	Japanese
vpxpyscowa	Japanese
evjman	English
kglhqwccano	Italian
bseofyama	Japanese
qbxzgopoulos	Greek
loulnftiis	Greek
dnrmzoaley	English
kamsyas	Greek
uiizdbzson	English
epyxsin	Russian
glisedaini	Italian
qruakis	Greek
tudgeyuko	Japanese
okgqjley	English
ckwin	Russian
jolmov	Russian
jvfmfjev	Russian
nfafdelli	Italian
izmtwwfeelli	Italian
apcyois	Greek
immbucci	Italian
pvbxvini	Italian
zzhko	Japanese
bosas	Greek
gkeciuov	Russian
ffjson	English
mcmqbko	Japanese
ivcqxkano	Italian
gvgnin	Russian
zaeqktzcano	Italian
ykrdoutdwa	Japanese
fsbwkfxwa	Japanese
fcsdos	Greek
sstiucci	Italian
djaycsky	Russian
wwmssis	Greek
jfnas	Greek
dfwson	English
jbebtqev	Russian
tqqqmmano	Italian
rcwreopoulos	Greek
dhvmovkley	English
jiwusdev	Russian
xdruson	English
gbqev	Russian
dlmrman	English
friwaman	English
ximfmpcuman	English
ekher	English
rnozson	English
majyetto	Japanese
puwnwmpas	Greek
wppecboev	Russian
wbahgson	English
awvucci	Italian
jzozto	Japanese
fnljcrio	Italian
vgsfpnyis	Greek
kwfhrvdakis	Greek
sgmugvuman	English
unqapxbwa	Japanese
hloyuhcqley	English
shccxopoulos	Greek
fvcugkhas	Greek
blapuappwa	Japanese
rryjsjvska	Russian
gzlomqopoulos	Greek
ychryama	Japanese
lctyiriano	Italian
fflskkdgelli	Italian
ktcljdsnsky	Russian
xwdini	Italian
pjkdvhopoulos	Greek
ylxtakson	English
phpelli	Italian
ienwton	English
bwgvfgakis	Greek
qcocka	Russian
xsyhljvoas	Greek
cfoer	English
hypgccas	Greek
hdarakis	Greek
hbnxwa	Japanese
vaahros	Greek
hwnas	Greek
wcvbbis	Greek
ejcwiarov	Russian
eqiki	Japanese
urprousky	Russian
jstley	English
gveyama	Japanese
ujvpano	Italian
gjjedbnlson	English
jmaov	Russian
jdgdhklkin	Russian
ebxpyis	Greek
htlnywoeson	English
zycwqzko	Japanese
rpwropnopoulos	Greek
cgqpoyama	Japanese
trcrley	English
ouuzfbiley	English
bildko	Japanese
kxqnqini	Italian
hidrrvapko	Japanese
xvbhuyama	Japanese
zkqktgucci	Italian
ukhvmxeov	Russian
jtgyhucci	Italian
cvskiaton	English
knoaebxton	English
gorvisky	Russian
llvulxkysky	Russian
jyboyucci	Italian
noowqqrzakis	Greek
wxezdybxson	English
vvaiyama	Japanese
pycdzis	Greek
dwolvpucci	Italian
dawjrin	Russian
cqniieki	Japanese
jpbwiley	English
pcdzadakis	Greek
yahhfkki	Japanese
jvjhzyaosky	Russian
mvnyqley	English
vitzzvos	Greek
ybizhqdzton	English
txqsseiki	Japanese
joajakis	Greek
vgbov	Russian
yjhehcas	Greek
mldqzdfoano	Italian
pbais	Greek
yoigelli	Italian
zvpjazano	Italian
ekcuveman	English
kidov	Russian
aueamapov	Russian
musgbzblman	English
vjiman	English
uhxylgko	Japanese
ekynddndano	Italian
wtjixenos	Greek
kkgoyas	Greek
mqexakis	Greek
rdiucci	Italian
jbfzgeglakis	Greek
hlqbwgvano	Italian
qakazpkson	English
vqcsvuozto	Japanese
zzjelelli	Italian
wppppijyano	Italian
izshbjopoulos	Greek
bnario	Italian
qemjrneopoulos	Greek
zgposelli	Italian
ujuzmos	Greek
edaas	Greek
flizlxsky	Russian
bcynbsakis	Greek
uxioson	English
emelvzdki	Japanese
dvmyini	Italian
lbuhley	English
vutqucci	Italian
eorslelli	Italian
czpsiston	English
zjtwxano	Italian
oxqdfopoulos	Greek
dpwjvxvzman	English
dqheeviato	Japanese
gmvepmdton	English
wayviyama	Japanese
mkvldcfrrio	Italian
cdalaewman	English
tfbpyujvas	Greek
fzqweopoulos	Greek
pzifgtto	Japanese
igyhuogxelli	Italian
gtnyxsfyama	Japanese
baerio	Italian
oyfcigev	Russian
svzmzkis	Greek
llpto	Japanese
lfaka	Russian
gcrohavakis	Greek
ptgelli	Italian
hdetpgwa	Japanese
jqkbyfvwin	Russian
uwaqenrini	Italian
bpefaruin	Russian
ydqsev	Russian
htuwano	Italian
ybehgcas	Greek
qxoldolopoulos	Greek
gfgos	Greek
rbznatjos	Greek
afzxiyama	Japanese
boqley	English
ulqwzpwa	Japanese
rkasksydano	Italian
jtoelli	Italian
ntjvmeton	English
nkdrdjyman	English
zhuriev	Russian
wimedpmisky	Russian
gsjdnzwrio	Italian
borvrki	Japanese
xwlrkoiakis	Greek
bmuin	Russian
enjcqothko	Japanese
tkgopbcto	Japanese
gdnxilvucci	Italian
ihoros	Greek
ajbpuselli	Italian
czqolki	Japanese
nwseos	Greek
xfpgkypdman	English
pfcehaini	Italian
ovqslakis	Greek
hewjfev	Russian
aasrzxyama	Japanese
zrgnutini	Italian
gicman	English
ugesqwa	Japanese
ritvtoxzki	Japanese
pzbnbapiin	Russian
zhhobov	Russian
scxvpjjgrio	Italian
cvxumhakis	Greek
fclpwpwa	Japanese
kilqnndqsky	Russian
xpjcifpucci	Italian
uciducci	Italian
pfngwivakis	Greek
ufeman	English
szqfdksson	English
wdgevwov	Russian
iqiylnozrio	Italian
vidxoin	Russian
jknko	Japanese
scdmas	Greek
umpzvorio	Italian
xnmmiprio	Italian
leaqvxksky	Russian
jkkfcpas	Greek
strqpka	Russian
rqpeoljer	English
ancvley	English
bntftrozelli	Italian
zvibbmopoulos	Greek
nngsbman	English
ihbman	English
wgshhacov	Russian
ivamliqka	Russian
qpkleano	Italian
smdkini	Italian
ntoiano	Italian
qgkcosrgko	Japanese
cvhklmntki	Japanese
gzrwzslwley	English
icourekvki	Japanese
dttxsdyxin	Russian
ntjupton	English
gmzvrjeton	English
dpsogopoulos	Greek
xtbcaeuki	Japanese
ybvztkxsky	Russian
rvofov	Russian
yzlson	English
uilopoulos	Greek
xinwfman	English
mknin	Russian
zhtgvlbqman	English
xemeano	Italian
rciahbuper	English
yqjcvifini	Italian
qjgylson	English
layxtto	Japanese
qbsuley	English
aeiiajis	Greek
taoin	Russian
rfhvkwwhsky	Russian
uuhpnlwa	Japanese
mcoeolrio	Italian
kjrdjton	English
mnndev	Russian
gzysxeter	English
wbeclbson	English
huhsbton	English
txrtukley	English
zopggley	English
ttbhin	Russian
tdeolthsev	Russian
vcjzfcini	Italian
ffbwmuxvwa	Japanese
bawas	Greek
migmano	Italian
gfxysrio	Italian
iefos	Greek
uefomwka	Russian
foqbuley	English
kvpdbtgto	Japanese
gbabsos	Greek
nguekqxnin	Russian
jmlrnyama	Japanese
rvjoyama	Japanese
iznugman	English
jmluzyvnley	English
kjxrio	Italian
dokpger	English
ldzxpmsin	Russian
slsnkznaini	Italian
hoxkefsmer	English
uecasis	Greek
kcxier	English
sulxgoelli	Italian
mnbicjman	English
gbftpyama	Japanese
hzpis	Greek
redatyger	English
vgtefley	English
cwvano	Italian
eriaozopoulos	Greek
gtbroakis	Greek
vjypmovtson	English
qejjmnin	Russian
jwrhnvako	Japanese
qnqfano	Italian
kksfkzuin	Russian
pzfmmsyman	English
koxfton	English
jwnrwtwfton	English
viofgyvvsky	Russian
innmdbldano	Italian
xmcrbmqmis	Greek
myxxqwqopoulos	Greek
iitios	Greek
zyuvtlcqton	English
knzchvjios	Greek
hwuhdrhakis	Greek
msxsky	Russian
nsczeuelli	Italian
tzhutryama	Japanese
ffzacmgdka	Russian
aaueelli	Italian
legos	Greek
muyvman	English
yasrfov	Russian
bfhdrtton	English
bdftwa	Japanese
hdvopoulos	Greek
kmswwaawyama	Japanese
suyxcomksky	Russian
jqhigley	English
lckwa	Japanese
ntddoyama	Japanese
aeperfos	Greek
bthucci	Italian
xgjuwsuov	Russian
fdmvson	English
twgfiov	Russian
evxyas	Greek
omfleubfson	English
dnoley	English
jfqxgfmpini	Italian
ycmoqddzin	Russian
rnxetafkyama	Japanese
qmiyelli	Italian
hyaffbko	Japanese
cpvzkis	Greek
valzgov	Russian
iycbvkaopoulos	Greek
aqiqkelli	Italian
npobhopoulos	Greek
notpbos	Greek
xhauomivas	Greek
qhkkwov	Russian
fofoutin	Russian
erfsadwrman	English
ldcman	English
iangin	Russian
cttos	Greek
fjbrio	Italian
cvpano	Italian
xcoyama	Japanese
rlzoski	Japanese
mguvcfzas	Greek
xvtajuev	Russian
chrvqdsbos	Greek
kwnpzin	Russian
ncskeiko	Japanese
adpbsezdki	Japanese
kcpoyyama	Japanese
vgraer	English
joqfrio	Italian
ekgxebtlko	Japanese
iqsrpzher	English
fofttgis	Greek
pvuafwiaucci	Italian
qmvngwtley	English
jrjievrio	Italian
rhkxymzer	English
htcrxrnvton	English
zephwa	Japanese
jamuman	English
nngsky	Russian
diwelli	Italian
mwgiwev	Russian
gmfzqrton	English
glober	English
llzwdano	Italian
jeccdton	English
sijskrio	Italian
ycurucci	Italian
uyjmelli	Italian
lcfakis	Greek
niyin	Russian
ivmjis	Greek
qofioxgas	Greek
ttqplyusson	English
abokini	Italian
uczqhano	Italian
fvhbkorto	Japanese
xgcaxucci	Italian
imjhin	Russian
vmfjgxbuos	Greek
nannxxsmini	Italian
ztunhxin	Russian
dzezzcqrio	Italian
ubmkancyas	Greek
lsayama	Japanese
kaexsky	Russian
baiybfin	Russian
ztrnzqhman	English
brmcev	Russian
jelbotmopoulos	Greek
uyoqifbos	Greek
ciieiin	Russian
phpfhwrnov	Russian
lfqwkxtucci	Italian
kvpwngrio	Italian
fshakkpopoulos	Greek
vturgmopoulos	Greek
pjxyama	Japanese
sgtixka	Russian
ayihsov	Russian
znxaeley	English
untumnwini	Italian
gljvomos	Greek
czfcbyama	Japanese
emfveopoulos	Greek
jdqazeilucci	Italian
qlzucci	Italian
mlhkfer	English
yoyxskson	English
nvlyykohki	Japanese
zxzxlxxelli	Italian
ffkucci	Italian
ozsubcrio	Italian
fpsyelli	Italian
svynkis	Greek
mpivsstson	English
hvqer	English
oabucci	Italian
kswini	Italian
ensxkton	English
wrkcelli	Italian
mwhkftas	Greek
jexki	Japanese
ibqer	English
mzhman	English
ccqtpqrio	Italian
eqfumlley	English
gwqbjdwtson	English
zzmyama	Japanese
xzvhson	English
jjcquas	Greek
uznbvfson	English
chprakis	Greek
fvcbshnpin	Russian
zoohnkki	Japanese
lljktyama	Japanese
qdtkzer	English
yxxddson	English
tgsklgman	English
txyegwhsky	Russian
lvxcev	Russian
kxzaoos	Greek
ianezzton	English
ojwdkuov	Russian
qpnfdrio	Italian
hxiveowucci	Italian
bfsjyama	Japanese
kpflfvbto	Japanese
zylqtgooson	English
rfriqley	English
svwakis	Greek
lcmvxktucci	Italian
wwsikmvjev	Russian
ykehsyama	Japanese
clfjeka	Russian
rlkipayama	Japanese
pyptvlyos	Greek
jmobxtvysky	Russian
eyukbxto	Japanese
abzwjvcoopoulos	Greek
phiwnbvhov	Russian
hvjyama	Japanese
tezvxcmwa	Japanese
kfpljuelli	Italian
vgeyrympakis	Greek
lvbrio	Italian
qcllxodwa	Japanese
vncnnrucci	Italian
shnelli	Italian
nuakswa	Japanese
wndini	Italian
skngman	English
lcqelton	English
cseceuopoulos	Greek
xjrywmakis	Greek
jqpsyquko	Japanese
gcsnhblfki	Japanese
wgmsfsky	Russian
xcniehaini	Italian
jmswyason	English
gdytcsko	Japanese
ovuako	Japanese
lhzmanzeelli	Italian
nglton	English
uxlpki	Japanese
txjfytucci	Italian
azjini	Italian
xfpgov	Russian
jyqfton	English
mgxzkevxelli	Italian
cdrqwyelli	Italian
ravnka	Russian
vnevcrkelli	Italian
ddufqycoin	Russian
zguopoulos	Greek
mhmuxtwa	Japanese
qcuhto	Japanese
sqikato	Japanese
ptbwfvvter	English
plglsky	Russian
gewixkewin	Russian
odsukbelli	Italian
mqorbin	Russian
wymksky	Russian
jzrtcqlelli	Italian
hqqfawcas	Greek
soopnev	Russian
hmxos	Greek
onleqto	Japanese
zymdsukver	English
aesjrisyas	Greek
xixkopznton	English
hrrnkukaov	Russian
wltas	Greek
oqgegswuwa	Japanese
mzadakis	Greek
euoini	Italian
drykvhki	Japanese
qprboeavsky	Russian
uwgrka	Russian
fayka	Russian
mpnhofos	Greek
ohjyiqhmer	English
aoudsuyama	Japanese
vkpzjgucci	Italian
pbkimoto	Japanese
cmixakis	Greek
xkinrurin	Russian
vbylqqnrson	English
kgdeka	Russian
nekipyley	English
bskqbjacev	Russian
ktzki	Japanese
acsov	Russian
gqqkimin	Russian
jxpjhmysman	English
brtidgdsakis	Greek
mpcqhedelli	Italian
jevruev	Russian
ucdcsson	English
tjxaser	English
sjcfksotley	English
xvhis	Greek
rwovnomton	English
mfxqskcgev	Russian
gstprgroev	Russian
wugaqdqgrio	Italian
wysvman	English
owafmymhakis	Greek
pdler	English
rkdis	Greek
cpqton	English
oomopov	Russian
wzvrakis	Greek
ybhbis	Greek
kzoiblakis	Greek
hvagopoulos	Greek
opqpdtsky	Russian
pvfmkkyrio	Italian
mjsnin	Russian
ldwxjkhoano	Italian
oxjzjley	English
kexnakis	Greek
wdqas	Greek
dkxin	Russian
zhrlyama	Japanese
njxnpbano	Italian
nyratrgqsky	Russian
hinkwbfin	Russian
nbhujxxano	Italian
whgyko	Japanese
hjtlis	Greek
obkckano	Italian
uemgrrato	Japanese
vxeocton	English
qxvmyfwwka	Russian
oxipnxzto	Japanese
pagvrluiton	English
ywfnqdakis	Greek
zteman	English
cyzwfis	Greek
ywaymflman	English
xdqlias	Greek
crtfkucci	Italian
ciyaos	Greek
mhagfley	English
pgkvjtson	English
syrmloini	Italian
swnuecgto	Japanese
qnfucci	Italian
kmjugjoki	Japanese
vqrfgasfev	Russian
fqtzuuas	Greek
vgmgcmto	Japanese
rjmson	English
fxmeqyov	Russian
wmjtson	English
zvpjsos	Greek
zhiuwhov	Russian
bwwson	English
hymnfyto	Japanese
lkjcjos	Greek
kotmefslos	Greek
aqjqncbmin	Russian
vzbfmajnka	Russian
doitvkgqka	Russian
mejicanmin	Russian
jkphecnas	Greek
viegka	Russian
lixios	Greek
zcuyama	Japanese
tqlato	Japanese
valuxannton	English
rkhhvsky	Russian
yciosyev	Russian
xzcfsucci	Italian
yysffson	English
vrclzufson	English
vledomros	Greek
ntnfev	Russian
ybpxhsky	Russian
tchtjhbhelli	Italian
xyfrio	Italian
mezhrhqano	Italian
yvhrio	Italian
igtsswa	Japanese
rylxqaghson	English
uidjrnis	Greek
ubqkzakson	English
qpvdksakini	Italian
gopfos	Greek
bpijipssky	Russian
wcpos	Greek
waagwwa	Japanese
qvqwiqrio	Italian
pygpjyitrio	Italian
aoehmmyama	Japanese
idearducci	Italian
nqtgka	Russian
ezrvser	English
gshylov	Russian
emtwa	Japanese
lewnnrwa	Japanese
gvxos	Greek
mpqcki	Japanese
iurcelli	Italian
pmifucci	Italian
ythais	Greek
htlexopoulos	Greek
urlgftzka	Russian
jwacyama	Japanese
ztpxjokano	Italian
vuooyama	Japanese
tbsnorcucci	Italian
zmksprio	Italian
mdybvgyer	English
pgmrxka	Russian
qxaev	Russian
vpkntuigov	Russian
fzdvqvzqki	Japanese
vxnko	Japanese
mkqopoulos	Greek
nhjyson	English
irkin	Russian
nodemkzpis	Greek
reyakis	Greek
pyrtka	Russian
ufisvakis	Greek
mauqjdxev	Russian
lgowhos	Greek
ongducci	Italian
smpapini	Italian
iirwdixwa	Japanese
bxxev	Russian
lnbehyov	Russian
njyboytpsky	Russian
qxffxrakis	Greek
zjeogxiiucci	Italian
xteldzuko	Japanese
gznnukiowa	Japanese
rwvxhvopoulos	Greek
wkgka	Russian
uwsbzton	English
drkgwmyama	Japanese
jhwaibsky	Russian
zbbjdgini	Italian
mpolepyaki	Japanese
oswxin	Russian
ngxkanev	Russian
ofsxtawjman	English
udpxnomis	Greek
bexljhson	English
hsckqjniki	Japanese
nbjmzton	English
ubvgopoulos	Greek
mwdas	Greek
vfmini	Italian
awtphson	English
zyvbton	English
nmkjuawa	Japanese
ufifuudwton	English
hkhwfakis	Greek
orvyama	Japanese
chqbkohelli	Italian
myzoka	Russian
jlklenos	Greek
aoaano	Italian
alftlbucci	Italian
pzijceyto	Japanese
sswrsnufano	Italian
temhknos	Greek
ufkvlcev	Russian
zysyowev	Russian
gpqiskgov	Russian
zgiyizer	English
avctpnwfos	Greek
nycmiton	English
ewznyev	Russian
zeever	English
xvqyama	Japanese
iqwov	Russian
xoctrrison	English
vihoyzjakis	Greek
mqdpka	Russian
xaqson	English
rzstakuucci	Italian
diaggjwov	Russian
rxdini	Italian
whkuqxrio	Italian
bufdyhcos	Greek
nsjnaeucto	Japanese
onyieqini	Italian
vxxlsqgmman	English
zitqrzev	Russian
xktcfmasis	Greek
hcxiin	Russian
vlpwdyrio	Italian
pqudgyama	Japanese
tlbjhqsrio	Italian
dmilbqmeucci	Italian
zeyeelli	Italian
eixrpmev	Russian
ndgvka	Russian
pikrmini	Italian
awkqgshjos	Greek
liuiis	Greek
qlsrqdsto	Japanese
tmlmtgsky	Russian
tnzeonwfelli	Italian
rhczfper	English
drgtxley	English
uprxyini	Italian
qacoton	English
anesjlaein	Russian
iohylis	Greek
ujwelli	Italian
axgis	Greek
wdqnvxnoley	English
nupxipin	Russian
wdcson	English
rhqano	Italian
orfmazculey	English
wpztylto	Japanese
jeekgshtman	English
elyppton	English
oilovkson	English
vzqley	English
cdjqano	Italian
hwmto	Japanese
smwyakis	Greek
qjfzzaywa	Japanese
wuwsyko	Japanese
vqztjton	English
mswto	Japanese
qkheos	Greek
jncnwton	English
nxouoakis	Greek
ysqzngwin	Russian
sktwev	Russian
ewcdwrkrio	Italian
ukubson	English
ogppsopoulos	Greek
vgqzsmer	English
tpvoscwrio	Italian
uezzeabros	Greek
dxisky	Russian
vntbmfas	Greek
pkskdev	Russian
swmopoulos	Greek
wzvzavqaov	Russian
lqwpfifvelli	Italian
ujxwsmnlto	Japanese
qgbldopoulos	Greek
oexkcfusky	Russian
yhkhrio	Italian
vovppki	Japanese
xzemzer	English
kbgvcaas	Greek
tciappos	Greek
azncvstson	English
mmwntki	Japanese
ezxcodelli	Italian
lmnqelli	Italian
elygin	Russian
welkropoulos	Greek
gkxapryama	Japanese
pfqwhutjin	Russian
xnxvcto	Japanese
itwko	Japanese
mvhdysmfton	English
wjihsyini	Italian
cutkmopoulos	Greek
bumman	English
wdzbwa	Japanese
iboqoxov	Russian
dcgxulyelli	Italian
uvuhtnlfki	Japanese
ksxrmooton	English
ljqssov	Russian
fwsko	Japanese
ytdkjwrto	Japanese
bveko	Japanese
ywdgman	English
sgpinafyama	Japanese
yrrjclton	English
wexko	Japanese
ifwuulcka	Russian
ycpnvlano	Italian
fehwlleakis	Greek
pvangazelli	Italian
ywfthzher	English
oqtpdlxman	English
unjpfnqano	Italian
nivlkyama	Japanese
eqhdyadrwa	Japanese
rbrpkmxev	Russian
xvkucci	Italian
akqadaruka	Russian
tpziipki	Japanese
gorzyxrin	Russian
mzujki	Japanese
hhjorio	Italian
snhgpseerio	Italian
dtclafgton	English
ruphano	Italian
kfducci	Italian
kuaano	Italian
ynatki	Japanese
ftcilsopoulos	Greek
nmasko	Japanese
dtrcoyjrio	Italian
nlgtouley	English
qozjqakis	Greek
lodhdzutucci	Italian
izxtmini	Italian
skfkki	Japanese
ppihouelli	Italian
hqiqin	Russian
mcztcko	Japanese
pklpsvris	Greek
ftbuyabkley	English
jlxdosky	Russian
rljbkko	Japanese
hijfjnein	Russian
gthhov	Russian
hglzgwa	Japanese
ksvrasopoulos	Greek
fxwdtmaley	English
pyukupqko	Japanese
zpgonhbston	English
suqxto	Japanese
naspvski	Japanese
kazybas	Greek
vboweucci	Italian
txyxyama	Japanese
othsky	Russian
leoqfler	English
aktjyama	Japanese
pdcookelli	Italian
yxzofizas	Greek
wszakis	Greek
bqvqjapkwa	Japanese
rzalgxmkley	English
nqgtwa	Japanese
xwalczsky	Russian
tnofcysky	Russian
kmris	Greek
zafpqkis	Greek
ryedjxsto	Japanese
hpdrio	Italian
nwgley	English
lqgbnrika	Russian
yyqdnoman	English
mnkvnbmton	English
lslozto	Japanese
dzakxrio	Italian
elajbfkwko	Japanese
qrcaurkzas	Greek
egkpqjas	Greek
ebqaejdawa	Japanese
bzoxyev	Russian
dmmaakis	Greek
yvdckuev	Russian
chujawwa	Japanese
ulbbbjkrwa	Japanese
rseeupamka	Russian
bumjtzjtis	Greek
ulxwuqini	Italian
mgrgmjpeman	English
kyqxdrio	Italian
xhhlczyev	Russian
iuuztton	English
hvtbybxbwa	Japanese
swraano	Italian
zxnpufkos	Greek
vsmini	Italian
ssqki	Japanese
pasley	English
nrrdhasky	Russian
mtdvfakis	Greek
bdmikev	Russian
elohdewa	Japanese
deomsqton	English
yfzyko	Japanese
zxusjpano	Italian
rbuucci	Italian
zodohuhos	Greek
dnbifmini	Italian
ocnkbano	Italian
lfnano	Italian
vvqxuelli	Italian
xtjxlios	Greek
hxoakis	Greek
tqpneov	Russian
zrzgopoulos	Greek
mkxfjfpton	English
zpjvvdjnev	Russian
zfnini	Italian
gjekler	English
rgeki	Japanese
grison	English
casvlano	Italian
lyepkalmley	English
bqiuqfwaopoulos	Greek
cemggjson	English
tgpqdxzhman	English
fohhento	Japanese
xnojntwa	Japanese
dsujymropoulos	Greek
svesjwa	Japanese
gzcgnplopoulos	Greek
ymnqiwtaer	English
unouqgman	English
cmdwsky	Russian
otakhjov	Russian
vrhggduer	English
admmirasky	Russian
erbdthley	English
xtulgcdlas	Greek
prdlphison	English
zcavmynini	Italian
fhwmlbas	Greek
enuto	Japanese
pruteman	English
uzrelli	Italian
dzyhkbneyama	Japanese
jbckptsin	Russian
ewtqcbka	Russian
ulfnqmopoulos	Greek
rgnucci	Italian
rzvfdjov	Russian
pgbqki	Japanese
ygsagka	Russian
eabkzxvin	Russian
zbpaufer	English
qkuotko	Japanese
tfchfohakis	Greek
fetzgsky	Russian
ovvfykison	English
svvhrev	Russian
jhucqko	Japanese
ltioryama	Japanese
usfxiyin	Russian
ntqhpler	English
aikrhrplini	Italian
pxobtsbxsky	Russian
zeduczsky	Russian
wqajgghini	Italian
nsniadbcano	Italian
ctvto	Japanese
fanffton	English
sgcmxieyin	Russian
hdmdwa	Japanese
egdacpcin	Russian
zsjkoxiov	Russian
tvuucci	Italian
rctini	Italian
nyozzsky	Russian
znhlucci	Italian
pznelli	Italian
idhuini	Italian
fzqzympdson	English
kxnafjko	Japanese
loooer	English
jsblpcpksky	Russian
wpvtley	English
zvylfmdkko	Japanese
twqtzwdki	Japanese
dpdkos	Greek
ifxev	Russian
jwzqev	Russian
nogcvelli	Italian
xpwwa	Japanese
avnmtkjev	Russian
lpxagiaov	Russian
mcoamdsky	Russian
dvein	Russian
hcvquucton	English
hkpley	English
niaacko	Japanese
yuxkjeymov	Russian
ejcdnigwa	Japanese
vwcditon	English
vmneiucci	Italian
hbuner	English
czcnqimbman	English
zlduwktis	Greek
wnmkeson	English
nikgyto	Japanese
yiszkain	Russian
ujddwsky	Russian
dhuvjunxto	Japanese
aprtvbupka	Russian
vxkoxmbyama	Japanese
haidwvkas	Greek
jphhiwelli	Italian
utphnytpini	Italian
nqylelhcin	Russian
iazucci	Italian
acxdqkley	English
swoiuaxko	Japanese
sakxano	Italian
lpseqcqev	Russian
emmqbmgxko	Japanese
fjcnudctas	Greek
zwxrio	Italian
pqutaqrxson	English
zgcydevyama	Japanese
ktereyfto	Japanese
fkmton	English
lawwto	Japanese
yndnfopoulos	Greek
cgizfin	Russian
egkuki	Japanese
pifzdvjxman	English
ifbothpev	Russian
uqoctka	Russian
kbvkucci	Italian
zkhuzayser	English
xvrpptzwucci	Italian
jvzfpgton	English
oehqxos	Greek
zcesechkyama	Japanese
uchugbdain	Russian
lyvbelli	Italian
siqyjwini	Italian
exefman	English
rpzman	English
wzpbyakis	Greek
sdhpini	Italian
roqgpakis	Greek
hdnley	English
mubqson	English
gocldthos	Greek
jiwtrrzto	Japanese
gouas	Greek
zhrddhzgki	Japanese
isimfjlkev	Russian
paakhlev	Russian
egirxdvos	Greek
vrzis	Greek
xhqkbzexakis	Greek
psryfkucci	Italian
lhoclnyjyama	Japanese
gxboini	Italian
nvpbuvki	Japanese
cdszson	English
cdskkxhako	Japanese
gxdgivson	English
ptcoayman	English
uugandzko	Japanese
bajlakis	Greek
pezson	English
iowjto	Japanese
riphelano	Italian
kesvtaev	Russian
zotudeson	English
xxbtwa	Japanese
vtahkwwwa	Japanese
dstyzznka	Russian
knkwoucci	Italian
oijfbkibev	Russian
wvknpev	Russian
zfbdxmuin	Russian
xtvhbacelli	Italian
cjblxurbrio	Italian
sciwa	Japanese
jqiabyama	Japanese
bajwnev	Russian
tomqzelli	Italian
rzolflnaano	Italian
tejmnekopoulos	Greek
cgqyama	Japanese
kxccqdfyama	Japanese
fvvlbko	Japanese
sktajsky	Russian
aocypev	Russian
nvipzpyxin	Russian
ubwman	English
hdsompbfer	English
dnqijirio	Italian
jlyuqtis	Greek
jcvrhfqyini	Italian
oueiev	Russian
twfysoxwwa	Japanese
wijakis	Greek
aasvjopoulos	Greek
imhzseuano	Italian
zqpraupyis	Greek
vuvzpnwa	Japanese
goqbkhas	Greek
dsdroson	English
rsojki	Japanese
nnwmybko	Japanese
dtglfmisky	Russian
vutgdonucci	Italian
qzlki	Japanese
sdaulki	Japanese
suvnpbvjer	English
pdiblzki	Japanese
elxyama	Japanese
ljitjov	Russian
trkozkelopoulos	Greek
iixriler	English
vupmyvngelli	Italian
ifawkaskelli	Italian
ofpxpequsky	Russian
skvqrpyama	Japanese
ifxunmais	Greek
ztrazuto	Japanese
vjirfuko	Japanese
wlbbrio	Italian
zdnlhpopoulos	Greek
qieipdnjko	Japanese
dmgvnskov	Russian
ktflyama	Japanese
tclntpka	Russian
tqegbpov	Russian
cggyxjxka	Russian
gypjsky	Russian
swfyyiley	English
racrio	Italian
lttdduwfakis	Greek
ibhcdrelli	Italian
tdinlsas	Greek
ueasky	Russian
xbltmnvton	English
egsjgakis	Greek
plvxjfqqer	English
pxphwa	Japanese
ykbxhaxfopoulos	Greek
vzcoko	Japanese
mflson	English
gfnotucci	Italian
uujvyley	English
oemrwoywton	English
xqvqakis	Greek
czfqnofucci	Italian
ipzrmtyama	Japanese
aomwzsky	Russian
tzmkfxas	Greek
kphcvqbeov	Russian
icwini	Italian
sceko	Japanese
zwhoini	Italian
loqdjtton	English
kacsger	English
vcason	English
jlmohchrio	Italian
bxwwcvwoev	Russian
colnos	Greek
afdwki	Japanese
ghtpzuson	English
dvjka	Russian
fczrtfman	English
ancelli	Italian
kiwsnmos	Greek
kcihkrxber	English
crwyama	Japanese
kbckxsky	Russian
dsktunbein	Russian
ygzwizyki	Japanese
nnbkiqkki	Japanese
plaifman	English
iybmsiucci	Italian
yxyki	Japanese
dxqfprio	Italian
jrrov	Russian
lrayama	Japanese
vzklpbakis	Greek
pxrmkber	English
jcjixetielli	Italian
zuaqrbwa	Japanese
kdhin	Russian
nyfnqitoos	Greek
icnxucci	Italian
jeaopoulos	Greek
rcouabnryama	Japanese
nlspelli	Italian
xuzomnxson	English
idozcev	Russian
zpnov	Russian
olydwxraov	Russian
rifqjlwa	Japanese
dqunppyama	Japanese
pewctxto	Japanese
yhjsdigson	English
dlfois	Greek
prhgnoiini	Italian
sdfvyblsakis	Greek
wouymucci	Italian
acfvyfkopoulos	Greek
rgnson	English
rbelpvbov	Russian
fwbxumwhki	Japanese
lktlka	Russian
dmomyov	Russian
nesmzlrmto	Japanese
eylto	Japanese
pgezbteto	Japanese
lbzrario	Italian
atorzopoulos	Greek
rpdrgujdson	English
anmkrjqjsky	Russian
ayaiopoulos	Greek
wzkuin	Russian
rtwupbmika	Russian
ltzajjton	English
ukxakis	Greek
ipaman	English
qsafonilyama	Japanese
vyber	English
trkin	Russian
pgrqyini	Italian
fpjamis	Greek
qkzaopoulos	Greek
khfalman	English
cklbdis	Greek
ioccrio	Italian
pvyylaxas	Greek
txwdka	Russian
qalini	Italian
eawini	Italian
ubixlyama	Japanese
stggzyelli	Italian
wtezymko	Japanese
iohqotgos	Greek
vlfgakis	Greek
blngnzov	Russian
ejdto	Japanese
tjtcto	Japanese
cshnmsjelli	Italian
gnlvwto	Japanese
jxkwtzilin	Russian
lbyakis	Greek
djmwhos	Greek
trspnyis	Greek
ybegaiezman	English
wqquman	English
smayekatsky	Russian
iaawa	Japanese
nmnqjobton	English
bxfokpley	English
ngnqalis	Greek
qbryko	Japanese
gbsoson	English
zsrfjopov	Russian
dqwmeyama	Japanese
qvuzungin	Russian
vfquucnko	Japanese
aamymzakis	Greek
fpsos	Greek
flfrvimkucci	Italian
rycvotsky	Russian
jdvttzotton	English
dbrbka	Russian
rxatrer	English
qorsbano	Italian
ginzas	Greek
woxuemos	Greek
gcvley	English
wnxxnjov	Russian
tspuvjhuini	Italian
xrawgoakis	Greek
ykwhodenley	English
ajckzkopoulos	Greek
dhuxogwcas	Greek
pvkton	English
pttixer	English
dprfton	English
zblutpnnman	English
jaoqiwmev	Russian
kooev	Russian
edttwpko	Japanese
kuekkvano	Italian
krznmton	English
fstbofeton	English
ibnvadkwa	Japanese
qfowsky	Russian
vrqghtis	Greek
vytqmeeer	English
uqxnfsrio	Italian
bhlki	Japanese
iurbrjelli	Italian
cwjysfneki	Japanese
laumbbxcman	English
jmubszki	Japanese
tzbscov	Russian
dnmlvskev	Russian
xhbbdrio	Italian
meuxpas	Greek
ukfman	English
vrsqovgbrio	Italian
dnmlton	English
bxoos	Greek
vmycdpcgas	Greek
elbanifein	Russian
hjsujki	Japanese
nvvlini	Italian
jppvano	Italian
nafka	Russian
slgwrrxpano	Italian
urpksxfini	Italian
cvlkfzqxelli	Italian
zdmer	English
vhuman	English
owijuyas	Greek
yweser	English
oqnpwuxjini	Italian
oeiuuyrio	Italian
pezzxzqelli	Italian
szario	Italian
zvcabtsoko	Japanese
ftqfsucci	Italian
muiman	English
qenlka	Russian
pybyfjqucci	Italian
kulin	Russian
sclyqxiis	Greek
lmldueyhano	Italian
ibwowson	English
nugos	Greek
ktujhkoley	English
taxpgini	Italian
fcudzcfton	English
edvqckiirio	Italian
sgyouobopoulos	Greek
aoatlov	Russian
mvgfki	Japanese
iwvyto	Japanese
koeaypley	English
ixpos	Greek
tzxuhotko	Japanese
vkfwugko	Japanese
ngmszdzakis	Greek
iidvzucci	Italian
hqlowseqis	Greek
xtadki	Japanese
ktxucci	Italian
pjozucci	Italian
lukto	Japanese
cuosman	English
gujpkmctin	Russian
mlubedov	Russian
fpqin	Russian
tyslqvyoini	Italian
duekhka	Russian
zngdtwaksky	Russian
tgfxroko	Japanese
pjvzmyffton	English
tpkgccxlis	Greek
rpevini	Italian
otgxdwa	Japanese
utizzini	Italian
smvikvsyopoulos	Greek
ivgriaswman	English
vclohvki	Japanese
auobkos	Greek
lcudos	Greek
urnton	English
plsson	English
xlnncucci	Italian
xovmzayama	Japanese
wihano	Italian
afmev	Russian
mwjolnrio	Italian
ogxesuppano	Italian
kanka	Russian
azyzxehelli	Italian
zjnywfdev	Russian
andmkhohyama	Japanese
yjfrucci	Italian
wqcuneka	Russian
szuton	English
bpdbnin	Russian
tbhnobev	Russian
iddopoulos	Greek
vpotnvgdakis	Greek
nobstopoulos	Greek
oitnceeka	Russian
aqvyopoulos	Greek
jwposrqakis	Greek
ygoltton	English
mrvnfoiqis	Greek
ybston	English
ipkslov	Russian
yzgmin	Russian
vcckmoyxley	English
arfrfev	Russian
tuzzdto	Japanese
nzkyama	Japanese
vufvzis	Greek
snuhpka	Russian
dutcev	Russian
xcwhmzsov	Russian
otbjnev	Russian
ibylvzrini	Italian
tyhucci	Italian
prscini	Italian
fnzrtbatakis	Greek
bunqcjjcki	Japanese
mddpyoveko	Japanese
anpbucci	Italian
xqxlrsky	Russian
aituppwvucci	Italian
pfjabhbgini	Italian
xzqrio	Italian
lsrtnfsky	Russian
juoniuducci	Italian
lqgflctucci	Italian
aezin	Russian
iteeton	English
ypbrksjvto	Japanese
fhtvxlxwa	Japanese
wiirelli	Italian
quadov	Russian
kpmtiydvano	Italian
trylev	Russian
gplaley	English
phdokfkman	English
ihiwman	English
gslzxpzsin	Russian
frapghano	Italian
nwiev	Russian
qbjzqftjini	Italian
rfqmflxlko	Japanese
fsgxxoayki	Japanese
ulqoxgmaley	English
lrevein	Russian
wvcnton	English
cclelli	Italian
oxaygjyder	English
kymwrqki	Japanese
pchossrpson	English
zwkis	Greek
rsrxos	Greek
euzyhvtmer	English
xlgyupzyki	Japanese
kdfukrio	Italian
earvman	English
ivizesucci	Italian
gqbki	Japanese
vmbxnsssky	Russian
ikcbmvqis	Greek
etecmesqopoulos	Greek
wfpqlin	Russian
hnusky	Russian
mtkuuin	Russian
ubvsmley	English
egkelli	Italian
rtsvzavakis	Greek
myaqccaopoulos	Greek
txfgwin	Russian
ynqaka	Russian
vqjizyielli	Italian
ydgfki	Japanese
ngrzhyyama	Japanese
vqbas	Greek
jwhbyspley	English
ymqwzwa	Japanese
rdrson	English
xpioftcsky	Russian
fmlka	Russian
magbeto	Japanese
cpqdin	Russian
fwhepev	Russian
rccrktzis	Greek
gaidmlsky	Russian
mcrsyama	Japanese
lhdbacoka	Russian
chmufman	English
uacgvobman	English
urctjacev	Russian
mcwhmboki	Japanese
fbuxjlson	English
anxgwvlis	Greek
ladmman	English
kcbjko	Japanese
dphblvini	Italian
ghvelli	Italian
mogbszeev	Russian
jcugksin	Russian
hhsbhki	Japanese
qlpightdley	English
awaazrjini	Italian
vmplyama	Japanese
jnqhudimev	Russian
hsiev	Russian
wvxwjmxano	Italian
dqdley	English
gfadin	Russian
tqrucci	Italian
xatdpyev	Russian
kdxsfmin	Russian
lzaimdmuto	Japanese
uqujgxtvton	English
rxuryurio	Italian
eailey	English
ahmwa	Japanese
pmyjcer	English
xwxpini	Italian
jkgcjlakis	Greek
arbbeucci	Italian
xsljpgev	Russian
ezoweko	Japanese
nucbucci	Italian
qfikbuqov	Russian
nvjobegnini	Italian
dpbznyama	Japanese
lfkkman	English
ixcoin	Russian
rasler	English
livbdmsky	Russian
blyrirfko	Japanese
gtggytin	Russian
dayyrfzsopoulos	Greek
dezbzmano	Italian
xnpmiki	Japanese
mfkbras	Greek
xvcano	Italian
sseloasley	English
ndaeqluer	English
hqvekev	Russian
hfvley	English
sdrydko	Japanese
ylfakis	Greek
ybkganpman	English
vrhzbhrqev	Russian
xnuin	Russian
sewwcsyama	Japanese
apdsoov	Russian
pjyjlas	Greek
sdjhqoin	Russian
rujhyama	Japanese
zlnpntktrio	Italian
smfxopoulos	Greek
wpgfer	English
ybgvutson	English
bknmykvzos	Greek
vhjelli	Italian
mquheska	Russian
zwrcuuki	Japanese
zxucsov	Russian
fvito	Japanese
xhoixvman	English
rbcgyama	Japanese
gjcglopoulos	Greek
xrendcov	Russian
mfaogirio	Italian
zyhxljos	Greek
lznjoelli	Italian
dymqrksfin	Russian
puxayama	Japanese
qtihrgbdas	Greek
lpqxdmlnos	Greek
bvzicqvakis	Greek
ejjmzwfrka	Russian
cogiwmson	English
gyzngcas	Greek
wcqcis	Greek
yesxto	Japanese
ajkauhayakis	Greek
sducmer	English
isfxpgko	Japanese
zdghxputo	Japanese
pzwyrdrcer	English
vsflucci	Italian
bfcgopoulos	Greek
nbuto	Japanese
jcxpyqoton	English
qpjtov	Russian
nwviko	Japanese
akwos	Greek
cnprcfqley	English
tuhturer	English
ybyris	Greek
uqdinser	English
khynsqxman	English
bofuer	English
dvcknzis	Greek
wmpley	English
vsiin	Russian
ciwyama	Japanese
aijodfbley	English
ejrojqer	English
goruko	Japanese
cphzzezoki	Japanese
wnyto	Japanese
vkucwhnrakis	Greek
nlyopoulos	Greek
wnsucci	Italian
hnmwhvhpano	Italian
qilto	Japanese
opwpqlucci	Italian
tikqhncrley	English
jjrsfgley	English
jeiwa	Japanese
flmrio	Italian
dpzqsky	Russian
zsrrcopoulos	Greek
ahoxngyfka	Russian
hzqini	Italian
picuelli	Italian
raqxmkkyama	Japanese
nydtsoain	Russian
tzgvos	Greek
tjbfton	English
jflbcmlrio	Italian
kpjqmelli	Italian
cavvpvxson	English
bkkpgqano	Italian
smaov	Russian
dnzvcvwa	Japanese
ommson	English
jwlmtton	English
qcjis	Greek
mtokokzler	English
mrgwa	Japanese
alghqrman	English
wsnsmmxini	Italian
zxvdqoykakis	Greek
jdjos	Greek
hjqoikson	English
mdshotbfman	English
atuwas	Greek
cvfcelli	Italian
kkotttabrio	Italian
mmzyrton	English
bmugton	English
qgowcuano	Italian
jdhin	Russian
pmptlzko	Japanese
exeitmpgton	English
npkkyosov	Russian
tjker	English
rwtwev	Russian
rxqerio	Italian
msidhvopoulos	Greek
iyrqnqko	Japanese
taqypqopoulos	Greek
cjdrwhkley	English
xtjtbvjzev	Russian
ifoboeano	Italian
kxeprrio	Italian
tkiin	Russian
pibokctman	English
imzos	Greek
rfrahkton	English
twdvaruas	Greek
poaxplos	Greek
suvtsky	Russian
fkmotpwyas	Greek
cypyki	Japanese
mfnnxoxka	Russian
mhzto	Japanese
gzrdhais	Greek
znejvtqner	English
immlzisin	Russian
ykhki	Japanese
zhisuano	Italian
edurio	Italian
brubyama	Japanese
thiqfrason	English
alhmas	Greek
ulmqnka	Russian
bbctfggyama	Japanese
zjaiini	Italian
okqwiwzerio	Italian
ncuzfpoko	Japanese
hhknley	English
acriano	Italian
mmcnwvelli	Italian
ylbxnjcais	Greek
jcuuphvsky	Russian
egiunwa	Japanese
nxcevini	Italian
ixnovfner	English
bctyqtfwucci	Italian
jvgas	Greek
uifkuton	English
vnzxuapley	English
zqjwin	Russian
hxyano	Italian
vitcqxev	Russian
wreviov	Russian
kyinwlceini	Italian
avuunddko	Japanese
oguoekhini	Italian
kriton	English
ytziano	Italian
awkivabley	English
ygdslbprton	English
kvgley	English
hyisky	Russian
tfmeakvler	English
meqjtplmano	Italian
whzhthtko	Japanese
casvano	Italian
qqlyoroka	Russian
avskpfxley	English
oqgavcrley	English
luusyvakis	Greek
yzuwxario	Italian
nfvkvrio	Italian
gfoyama	Japanese
qolqokbzakis	Greek
vebopoulos	Greek
ebimzsboano	Italian
aumiripton	English
fbejuzier	English
phudspcrka	Russian
cfbsky	Russian
ftvucxki	Japanese
iencuymnopoulos	Greek
capwshano	Italian
knlewwson	English
dvyyis	Greek
acxmcuqhsky	Russian
fsbbpev	Russian
mmwwigbrin	Russian
ervhdin	Russian
gejmwa	Japanese
dbmbzmini	Italian
uhpoqrko	Japanese
idrson	English
ofzka	Russian
viptzrxov	Russian
dobxlymiin	Russian
kruloyloko	Japanese
zxhmin	Russian
syxiyptcini	Italian
wtsugxpakis	Greek
wmkfgybucci	Italian
kggigov	Russian
rfazobaini	Italian
yolkioer	English
ytnzjzwcton	English
ekcdpeuman	English
zlqfov	Russian
mhvhyama	Japanese
zxiakis	Greek
wqwnwcdsky	Russian
ajjwhbmano	Italian
ecdeodki	Japanese
asqos	Greek
nhleckto	Japanese
guodcaki	Japanese
rnquniin	Russian
jphano	Italian
nrskgopoulos	Greek
kfkorio	Italian
ssuwpwpto	Japanese
cmumbis	Greek
uhvpxadison	English
wubvoos	Greek
ydttmxvuelli	Italian
bujpton	English
wsncwson	English
utwlvvuhelli	Italian
cmeyvakis	Greek
frxyqcev	Russian
bvzgasko	Japanese
cuqgisky	Russian
gnhknqbucci	Italian
tuyhjpto	Japanese
idwnomeducci	Italian
jhatnjpjto	Japanese
gemqhxjqopoulos	Greek
xufskdnsky	Russian
sbrjliqzis	Greek
opghyama	Japanese
qdevyley	English
mhiaizyama	Japanese
xiionkis	Greek
mtmqzer	English
sfcplcin	Russian
lwveka	Russian
iuoawano	Italian
alzoivkwka	Russian
nnjroqev	Russian
rvhdsky	Russian
bpryhgwa	Japanese
rfuzeas	Greek
jzyrucci	Italian
avglzhev	Russian
nwljndev	Russian
uysov	Russian
djvyohsuov	Russian
quhzkqier	English
avdeopceopoulos	Greek
dkmuqkgtyama	Japanese
vojas	Greek
iaqavgako	Japanese
ffsubmidakis	Greek
krxjbeakis	Greek
nikenuer	English
eqafhropoulos	Greek
fnbaraano	Italian
avdqyrqos	Greek
haakgoreka	Russian
xpufzxuto	Japanese
aocbka	Russian
sxffgwka	Russian
umfdliyama	Japanese
csrboayvelli	Italian
etvfwtjeko	Japanese
kryhwa	Japanese
wmgrakis	Greek
uuitklakis	Greek
teysky	Russian
lqqloman	English
himuguqtos	Greek
vtawa	Japanese
plgawueucci	Italian
ixsko	Japanese
tjcnoskusky	Russian
otyqka	Russian
kirczov	Russian
dpufqikakis	Greek
xpisibbucci	Italian
fryqmlley	English
vfabruov	Russian
zacspjelli	Italian
kvevteano	Italian
ylunqawwucci	Italian
txaadkucci	Italian
ygmeev	Russian
tuvjzton	English
eldka	Russian
uoejwiin	Russian
lzpwpfjka	Russian
jomhbvko	Japanese
oevrtson	English
zvbos	Greek
iuojyama	Japanese
iyeos	Greek
gakyley	English
ohgynko	Japanese
pmlolxler	English
qnrkmley	English
xnyrio	Italian
pqfvmjqrio	Italian
bbbfev	Russian
muikhelli	Italian
tqlesiucci	Italian
oajdwano	Italian
kvxrio	Italian
pbnter	English
qdsin	Russian
ruolka	Russian
siffsucci	Italian
ghuejctvka	Russian
xccqadki	Japanese
zojgmbirko	Japanese
qkteodisky	Russian
yipitguwa	Japanese
wqrsgwko	Japanese
muxyama	Japanese
pzomjxkqos	Greek
gcztnas	Greek
cwosxbuzson	English
vcenini	Italian
wpjbeucci	Italian
tlryorio	Italian
lsdufopoulos	Greek
hbpakis	Greek
gdzqwwman	English
jdfxhyxano	Italian
wfgfzlwucci	Italian
fjlkpcdyin	Russian
oiygkdzjley	English
ngepwbeman	English
iubeqxov	Russian
ayupmhev	Russian
givnini	Italian
xmghxlmison	English
fszrvpbzto	Japanese
dlxxini	Italian
uxhldpeuelli	Italian
lbixxzvwa	Japanese
fmbuyis	Greek
jupefer	English
xlzhbin	Russian
htaov	Russian
uqtepano	Italian
ibqpson	English
rzvhhkano	Italian
hqlsrcucci	Italian
igtsyojley	English
rbblwlpto	Japanese
aotxemuton	English
vjajiolov	Russian
zkaknvin	Russian
qtytuini	Italian
rmspzto	Japanese
fjfber	English
bmhson	English
bnsopoulos	Greek
hmyhkscyov	Russian
ebermdeeelli	Italian
nvydiawman	English
jeeixucci	Italian
jhaeman	English
baadgeoqley	English
vvfivhkson	English
sdwhkhis	Greek
mdupnis	Greek
xwqinopoulos	Greek
byrytki	Japanese
lgmciarto	Japanese
obtbmhhmov	Russian
gdxknpman	English
pxyto	Japanese
sejkko	Japanese
pwoogrxis	Greek
qecirio	Italian
ffffqhgley	English
qkfxsky	Russian
tamepson	English
jbxvdijcis	Greek
ffseiano	Italian
vaqvusto	Japanese
hwulbinfakis	Greek
uoider	English
rzxhgley	English
uslztcxko	Japanese
hybsuev	Russian
plslbqwelli	Italian
ehfxwvelli	Italian
parin	Russian
ntjqjmvin	Russian
xuylfxucci	Italian
rhxluin	Russian
ruyrio	Italian
veovos	Greek
evvlzer	English
xvbev	Russian
nfujcenvrio	Italian
uqazuswa	Japanese
ksmjpbhgin	Russian
jykyelli	Italian
nkiman	English
ucjhjbman	English
lewwa	Japanese
btcer	English
huatxlhyama	Japanese
lfxyton	English
ojorobnrio	Italian
jfqnuto	Japanese
vxaoqcov	Russian
bdejjqyaev	Russian
ujeddxqki	Japanese
suaaiiscini	Italian
fwgwcxev	Russian
ajstis	Greek
njbicecbin	Russian
ivgcazllov	Russian
lxqley	English
kbmnaynki	Japanese
didiqhlcano	Italian
sldwa	Japanese
pbveckman	English
ddkddcopoulos	Greek
pdigyltger	English
mduin	Russian
uiwrio	Italian
lgdwbton	English
cfeaoeer	English
ujkxxfjov	Russian
nxzbxtnakis	Greek
yhhnbson	English
xutshzcka	Russian
iybazttvka	Russian
xtowov	Russian
vwzuis	Greek
ojxckwsas	Greek
zliuis	Greek
kbemniufrio	Italian
wnutmniley	English
bkcsky	Russian
xewoeigaopoulos	Greek
ptqhvmki	Japanese
capaqwewa	Japanese
tzhulcwsky	Russian
ydlosfbrman	English
mcwmufson	English
eszkxdsky	Russian
mbvrnsnyyama	Japanese
riasky	Russian
xsfopoulos	Greek
gynayqki	Japanese
gstuer	English
mwmupnov	Russian
aquauini	Italian
vtbucci	Italian
nutman	English
wwsucci	Italian
lnjjzov	Russian
xjyceigopoulos	Greek
blawftka	Russian
omcakis	Greek
qdxjtrgnin	Russian
tahecopoulos	Greek
swcdyki	Japanese
klawvzyama	Japanese
pkugini	Italian
luveftano	Italian
rhrmbgsbsky	Russian
jrnolmki	Japanese
yzkcano	Italian
vwpjgley	English
aqdfboley	English
agprcadasky	Russian
qeher	English
atvtasin	Russian
wqrzzlini	Italian
csapmiwa	Japanese
bihzsjxrio	Italian
ueewfoin	Russian
dakiyuson	English
maxfqujzton	English
ksecwqskrio	Italian
zmitsggakis	Greek
lgtcryama	Japanese
rjroton	English
jjihxwhvin	Russian
yuubtbley	English
khyxotano	Italian
ygdqwgwa	Japanese
saafjsfuton	English
fgjmxos	Greek
zfdrio	Italian
xaqtnbyama	Japanese
nkqtoqsky	Russian
xlnlucci	Italian
grkiwuber	English
kawhsrmgucci	Italian
immtyaqder	English
qmbetwmano	Italian
vrwhson	English
gapaotzducci	Italian
wqwpqin	Russian
lbqsky	Russian
zkcftley	English
uxiliycley	English
yprqson	English
pywjelaoano	Italian
ebgtlvbson	English
nookkabwa	Japanese
kpzuumwbman	English
ggmcifwa	Japanese
clycnto	Japanese
knnwcuiley	English
iuhnjrkcton	English
wovlopoulos	Greek
bymcwa	Japanese
cpvwa	Japanese
mjaxbbxka	Russian
nvqzger	English
neoqhuzropoulos	Greek
mkiaehwa	Japanese
jldto	Japanese
vayerto	Japanese
zuynkto	Japanese
vmplopoulos	Greek
lyikvison	English
suqysman	English
ltlkhmas	Greek
vbsiton	English
iipmlka	Russian
vywacrxton	English
tfobihqrwa	Japanese
oclywqher	English
aestrio	Italian
kjifzibman	English
ryajwopoulos	Greek
mwxutwrakis	Greek
womgivfin	Russian
ozodder	English
ogpzrckki	Japanese
fcxpgmin	Russian
xqxpsky	Russian
awugcka	Russian
nnywdnsky	Russian
vvmtxrqxucci	Italian
mfxcqeto	Japanese
suufeirio	Italian
rnobvodmki	Japanese
iqvsloteev	Russian
lwfgketko	Japanese
ztgev	Russian
yohiev	Russian
jpydini	Italian
qffcrini	Italian
cocztos	Greek
nopki	Japanese
dgdzopoulos	Greek
hrggmano	Italian
kahlhman	English
cbdfkjwmton	English
cjssvtlucci	Italian
bhdwzpyama	Japanese
rvxelrelli	Italian
cizman	English
lmzgzrio	Italian
qqvzhnqki	Japanese
ujvjxjley	English
avmis	Greek
oygseuson	English
zaiesjetko	Japanese
ctfer	English
guyzuwa	Japanese
tvprfbka	Russian
gqpeddeais	Greek
xstqis	Greek
bdlayvyas	Greek
jpncnakis	Greek
umqbhbjxov	Russian
vwinqov	Russian
ygdighnaev	Russian
gfdxdyama	Japanese
sktuxucci	Italian
cyvptxdley	English
zvbtchmwa	Japanese
unkwseov	Russian
jrugzmaucci	Italian
nqaov	Russian
vgxnaka	Russian
gtjluto	Japanese
pgebasnini	Italian
gkgzuov	Russian
fzylrio	Italian
vrrxrley	English
tpbinev	Russian
kkldvmsxis	Greek
jbkyuoyzer	English
usgev	Russian
duahquyley	English
mympovatev	Russian
qkvley	English
wbiwgtito	Japanese
bzqakis	Greek
kyzras	Greek
zgtwrbgki	Japanese
opgyov	Russian
lrzley	English
uwjqlgwyama	Japanese
qorczto	Japanese
xslini	Italian
kbxini	Italian
hwwopoulos	Greek
babiqlev	Russian
yxevgviqov	Russian
sjvkfkkhka	Russian
klncwa	Japanese
evwucci	Italian
bcbtgvis	Greek
esidpin	Russian
djqsky	Russian
ywbtmer	English
ncedmznwley	English
cwubaccelli	Italian
wadnton	English
klumuois	Greek
rxuzman	English
jdjhjjmto	Japanese
axpivtuson	English
qvxsini	Italian
tlatyxifucci	Italian
rhmekoin	Russian
awqton	English
jdblscer	English
qxxclkkyama	Japanese
slwzlis	Greek
ihukeeos	Greek
erjewa	Japanese
uvfsrbis	Greek
tcuosky	Russian
yduuhwa	Japanese
jukton	English
hdjas	Greek
xlhbto	Japanese
ichaov	Russian
gcjin	Russian
fcjhorio	Italian
valkvtexis	Greek
avenbxwa	Japanese
mtuptsakis	Greek
flmvsnuywa	Japanese
glain	Russian
ttmofki	Japanese
gsnqyama	Japanese
ddtjpkov	Russian
febdcezpini	Italian
ewlselli	Italian
wegyrczjman	English
ncnton	English
pjvjnspbopoulos	Greek
tqzka	Russian
zddano	Italian
oehsbgpyama	Japanese
lqmafmjeelli	Italian
xjkzko	Japanese
jwmxsgocas	Greek
rplaqvalki	Japanese
pqiev	Russian
bexrio	Italian
tifijhoucci	Italian
mnbjjrton	English
drqyama	Japanese
qfxki	Japanese
hjoojsnoko	Japanese
weohwelli	Italian
qzqdknpkev	Russian
zkiuev	Russian
otouzaxoucci	Italian
oubjuuev	Russian
aacpelli	Italian
depflka	Russian
ufsley	English
oweiblano	Italian
ufkdppjuucci	Italian
keumjeano	Italian
jeqxezman	English
ebicov	Russian
smbofki	Japanese
wbvdano	Italian
nbtnohopoulos	Greek
bbshfson	English
mxtgzis	Greek
xanxlov	Russian
mudvxykko	Japanese
ivlegopoulos	Greek
icdxazbelli	Italian
smpmxbjov	Russian
hfdlyama	Japanese
dtmpsto	Japanese
akqnlhos	Greek
zgiffbpbano	Italian
zvbton	English
ferowa	Japanese
kqsgxmpas	Greek
xmbcpymton	English
gqyqbdos	Greek
bulfka	Russian
qhlfman	English
pkbijzley	English
uhufiika	Russian
rinbidis	Greek
mxxwa	Japanese
jeoshgvsucci	Italian
edjki	Japanese
mtxybjpvin	Russian
etnev	Russian
csxbyano	Italian
obftvnton	English
agknysky	Russian
fyimvier	English
jrywa	Japanese
ssbin	Russian
xhffvmrio	Italian
ydcopoulos	Greek
dfltwis	Greek
zscmko	Japanese
yeetelli	Italian
ricrrio	Italian
mcpmlvrio	Italian
vilqley	English
napsrgman	English
qgxelli	Italian
gmudlusto	Japanese
qmmuqako	Japanese
slnkhbov	Russian
zeplov	Russian
wnvaas	Greek
teryama	Japanese
ozciman	English
zpjosky	Russian
hsfuevnko	Japanese
skifpopoulos	Greek
hxxyhmxley	English
eyjaopoulos	Greek
cztltqdton	English
qaszqyatka	Russian
biatghmxis	Greek
iyjkto	Japanese
ltiempman	English
wwwpffeder	English
ekbyini	Italian
sgyfsoiwa	Japanese
wvmev	Russian
armfyjka	Russian
hgsrio	Italian
axkokeuski	Japanese
jpcvcqcgto	Japanese
egxsdsov	Russian
mklbyopoulos	Greek
swvqkzson	English
xnulltko	Japanese
tmnakis	Greek
bxfegmwa	Japanese
wszzlvdano	Italian
vaxigver	English
tdnenman	English
opyiwisky	Russian
dfvjman	English
zspgqcvxka	Russian
iogdin	Russian
bvfucci	Italian
hxrkaqxelli	Italian
pdajer	English
kcgkunxger	English
wocley	English
hzgyliin	Russian
lighuuqfev	Russian
pznucci	Italian
wvebopoulos	Greek
susxas	Greek
wbfqjloini	Italian
svdysvakis	Greek
xfljttsky	Russian
khxnkov	Russian
qndzman	English
wjmcndki	Japanese
ihhovov	Russian
zwhmpcepwa	Japanese
ntywa	Japanese
fdoley	English
avvmtopoulos	Greek
noebicrton	English
gctydumton	English
okxwrmwiopoulos	Greek
ydtelli	Italian
hdokkini	Italian
dndjwhucci	Italian
htoelli	Italian
kjlonsyama	Japanese
cielvos	Greek
mgnvxos	Greek
kukfqyqman	English
getley	English
qgjglrwa	Japanese
dtoyonhakis	Greek
mwzvseeano	Italian
pwngrio	Italian
qpdcki	Japanese
lguktyev	Russian
tilzini	Italian
sqtkqyveko	Japanese
nhzzbtsrio	Italian
kkwuidoley	English
ytjhcjswson	English
clijini	Italian
omejeras	Greek
bjaylto	Japanese
wozaglioki	Japanese
bozvki	Japanese
pkcvuasos	Greek
ulydtjapto	Japanese
zndlxson	English
wxcrio	Italian
eseebseev	Russian
gtaafswlov	Russian
cjoivoftka	Russian
llkehpqgka	Russian
tplpwev	Russian
rjjemhelli	Italian
yurrer	English
csbgwwa	Japanese
zbreas	Greek
bdnzov	Russian
yzivxizsyama	Japanese
uxshjson	English
pxuggjwvto	Japanese
odrxedursky	Russian
vanvgssky	Russian
qmoley	English
cvzarzbesky	Russian
hmsvpayis	Greek
tkhzlnano	Italian
cctuvgljrio	Italian
mhsswmfer	English
fhqwitebsky	Russian
ultcikov	Russian
tuais	Greek
lypeqmthakis	Greek
suzcini	Italian
phhgqfomwa	Japanese
rvbfwer	English
mqtswfis	Greek
rlxkxis	Greek
avdev	Russian
yjrjpucci	Italian
oiber	English
wroagvefov	Russian
kttbelwa	Japanese
hscagfaas	Greek
bhupeqycov	Russian
oftkoklson	English
gobubpley	English
xggwazffwa	Japanese
mnnrttsky	Russian
pjnfov	Russian
jlswer	English
utlmas	Greek
csftwa	Japanese
sxsas	Greek
yjpano	Italian
ngyoyrman	English
jyqlrnano	Italian
nslvkvki	Japanese
akdrnlbmki	Japanese
ysnikcdlakis	Greek
teknqin	Russian
fnimtin	Russian
bxrbzas	Greek
awumhqto	Japanese
bwjdnis	Greek
azuufyama	Japanese
fkfdis	Greek
afsvxjiton	English
mhkxdjley	English
spuckyama	Japanese
tkilyzrtman	English
huhkqas	Greek
utvtycnakis	Greek
lyuuucci	Italian
erwpano	Italian
aswbov	Russian
pvjakis	Greek
ycdcwa	Japanese
hgnasrakis	Greek
kvaev	Russian
ymudtuoano	Italian
wltin	Russian
givjltxano	Italian
awjman	English
qjcqfrunev	Russian
borofkkini	Italian
dkdtbucci	Italian
loyoaoley	English
avmcvnsiyama	Japanese
dfrizley	English
tkyzlser	English
poxbopoulos	Greek
eentvdlopoulos	Greek
vitanaquis	Greek
daafwhwa	Japanese
eatyilswin	Russian
kypis	Greek
igrluvnelli	Italian
lsqwxiley	English
xrxpka	Russian
drqyama	Japanese
xhhin	Russian
vfggdas	Greek
icuoson	English
epqki	Japanese
hhxqpyakis	Greek
xcgvffxov	Russian
fbjjakis	Greek
whkdtpqyucci	Italian
islpdzov	Russian
vktsini	Italian
zufqjfeiov	Russian
wdrto	Japanese
ppvisky	Russian
hbkrio	Italian
kwzuos	Greek
hhlqyama	Japanese
qfyfbcer	English
wptnrljton	English
cmoson	English
fbqedeev	Russian
yvmnjxev	Russian
esedywman	English
uddelli	Italian
tmrwsano	Italian
escqjqska	Russian
ivxsiucci	Italian
ljoeyama	Japanese
izjevdrio	Italian
hsisairio	Italian
jjiano	Italian
zlpjqczjwa	Japanese
ewqyqley	English
mkartto	Japanese
hcprjsky	Russian
tdhyin	Russian
pkiqhtgopoulos	Greek
exyoxdwa	Japanese
fidfano	Italian
gqvgiydfev	Russian
fhoeyama	Japanese
ctplgki	Japanese
bnhfhttrka	Russian
ghlfdako	Japanese
guollvrelli	Italian
fcqtwa	Japanese
xbrucci	Italian
swwsqwvini	Italian
dztakis	Greek
rdpwucci	Italian
eyuaner	English
vsxuer	English
zjggano	Italian
owdytoeuos	Greek
svgelli	Italian
iyguini	Italian
ucvxyohov	Russian
hejuto	Japanese
quzvpyfjev	Russian
hsxapdeyama	Japanese
ptzrston	English
bejos	Greek
vfpyfijakis	Greek
bomsucci	Italian
ergccka	Russian
qsldnmwa	Japanese
rbbev	Russian
ayeoorio	Italian
vehov	Russian
kplcyama	Japanese
gmnka	Russian
jhsypuelli	Italian
zouzcakis	Greek
qcmhbelli	Italian
szcrsky	Russian
gpekdcman	English
qbxgyxcbis	Greek
hoalyama	Japanese
vjrxfvwa	Japanese
sfkjton	English
vipmhzcnucci	Italian
lltbgin	Russian
lxjfelli	Italian
innoki	Japanese
nwpmson	English
uosaiwa	Japanese
yejxelli	Italian
tznieev	Russian
orbmihpini	Italian
mbwugjyzakis	Greek
hcdnbdas	Greek
hstlfyama	Japanese
uxvkizfiov	Russian
avxigin	Russian
wqnakis	Greek
zqhkqwxev	Russian
uhnikiuucci	Italian
ytosski	Japanese
lxjfucci	Italian
yjgmqfzpev	Russian
ispvqkbki	Japanese
nzpfykhbakis	Greek
qarmoka	Russian
lddthis	Greek
pcuwusucci	Italian
okfgopoulos	Greek
axeka	Russian
umgkczyucci	Italian
oblgfyama	Japanese
hmchvuacas	Greek
izdtpfucci	Italian
vbgrio	Italian
qamsyto	Japanese
xyyxqsibson	English
cgbyhwin	Russian
odqinosov	Russian
pzwhpgos	Greek
zeoltfpwa	Japanese
cbaki	Japanese
opjbatwoos	Greek
geluvwzin	Russian
cramdaqkto	Japanese
apbyama	Japanese
eyesky	Russian
wmrgka	Russian
dxbdcka	Russian
msgzixsdov	Russian
ntqpcbyama	Japanese
jcczzynelli	Italian
exeldsmer	English
kqumdnoman	English
pazsky	Russian
jztmkano	Italian
wixfov	Russian
zekziuqbas	Greek
tkafjto	Japanese
yenghlfhini	Italian
kjqopdvgto	Japanese
amcwsky	Russian
eahdyqnoopoulos	Greek
jqffqki	Japanese
pgtos	Greek
tnhbwka	Russian
moynfski	Japanese
fzwtnujtka	Russian
bizwpdnjka	Russian
kuqixano	Italian
oowdhki	Japanese
gifoqka	Russian
fqoygezyman	English
nkiyxrwa	Japanese
jytyzjton	English
uiubgini	Italian
udjhin	Russian
ysjlgko	Japanese
gehjas	Greek
lmnqman	English
txynlyper	English
uevazhwucci	Italian
dghopoulos	Greek
ztcwa	Japanese
adjcdcwa	Japanese
umeis	Greek
htifrov	Russian
roxmkov	Russian
mgtopoulos	Greek
loxucci	Italian
zlcson	English
cbausijis	Greek
eopsky	Russian
vmkton	English
eounuis	Greek
uqfopoulos	Greek
mzonman	English
jhcov	Russian
htqpcwa	Japanese
fnxjeka	Russian
zmver	English
jgqto	Japanese
cnpjwxewakis	Greek
jblrjopoulos	Greek
rzsjrio	Italian
zqspelli	Italian
tosrsucci	Italian
zjkler	English
uiedaadjka	Russian
ddypoqas	Greek
gsxubano	Italian
trmmexntto	Japanese
skzhson	English
vueulxlgka	Russian
fulmwgopelli	Italian
lfjlka	Russian
dhdyama	Japanese
ldphvgev	Russian
nejsis	Greek
cknsjev	Russian
prpcocher	English
lwvqakis	Greek
lzika	Russian
nfxpgley	English
gvygdki	Japanese
auttsky	Russian
vrvxwpakis	Greek
vwppano	Italian
hmvozsky	Russian
soxlbmmtka	Russian
uexrkxmqev	Russian
jcnjsis	Greek
yccer	English
wrkjafmxto	Japanese
bmwwvzasky	Russian
fhvlyama	Japanese
fetvcopoulos	Greek
cgwboxelli	Italian
ocuvjqjas	Greek
gaaouano	Italian
yoxppjduano	Italian
zldqgdmhto	Japanese
hzhwnman	English
oxlowka	Russian
bobfkaki	Japanese
nbmsuvwa	Japanese
lwencbnka	Russian
llxgemas	Greek
duwicto	Japanese
vyielli	Italian
qjqgksopoulos	Greek
acrsky	Russian
pdmugqrov	Russian
wvsuis	Greek
sdqko	Japanese
rdtropoulos	Greek
dnkaos	Greek
oxlopoulos	Greek
adqbqnwowa	Japanese
nejtson	English
vqthelli	Italian
zmnas	Greek
pgcgctin	Russian
hdhkewzrio	Italian
zzlkko	Japanese
nvlccqman	English
ynuykdrio	Italian
dofpdyker	English
gnfrcxgjos	Greek
aggjmson	English
snuqowa	Japanese
uxjnwwa	Japanese
iredqpgtucci	Italian
yeker	English
ppibylbis	Greek
cgjyvin	Russian
rwvrio	Italian
ntsnwxhrrio	Italian
ppchjini	Italian
xhuzqman	English
anlrio	Italian
xxtonmlton	English
ybnpubhtman	English
ovpoijson	English
vrigspdxov	Russian
wbagas	Greek
xhkxyqfin	Russian
gvxebgov	Russian
mmjnwlov	Russian
pqzqpakis	Greek
rqjlquwki	Japanese
lowspcdjakis	Greek
tjncutov	Russian
wfzhuwswa	Japanese
ruxsky	Russian
vqmmqnley	English
qjeaahfopoulos	Greek
uhbano	Italian
ddiyfson	English
ldzhgkto	Japanese
tlpnbis	Greek
wcarizakis	Greek
spbjykgqton	English
mcewysopoulos	Greek
medugkwa	Japanese
ycixhdano	Italian
qugvjrusley	English
cfbbucci	Italian
bjbyafiini	Italian
gmwwa	Japanese
zpxhman	English
juejov	Russian
odzqspmfini	Italian
tvxxjxto	Japanese
dbdpis	Greek
ryecwwa	Japanese
ykaxpvka	Russian
cheiyama	Japanese
mctnwuuano	Italian
mmfpcilin	Russian
kwrwnyka	Russian
ygoqwa	Japanese
dvodfcko	Japanese
gwutzcpopoulos	Greek
vypyama	Japanese
fuosin	Russian
ijkfoqjgson	English
trpqov	Russian
nksjxko	Japanese
yrnruxjtka	Russian
itwgwfagko	Japanese
mrmqton	English
vgpllxzpka	Russian
kpwwmano	Italian
seiton	English
aqdhelli	Italian
lolaer	English
fnmjsky	Russian
yasiklxurio	Italian
jysman	English
fezvipki	Japanese
greko	Japanese
cbbeikka	Russian
yniduousis	Greek
mtpthvyis	Greek
hqgxis	Greek
nrqgrxopoulos	Greek
zqelqdois	Greek
nrdmlfxeis	Greek
pzuucci	Italian
prphas	Greek
stqson	English
itmavggwa	Japanese
ytxlbrmton	English
envunfrcson	English
ooxozyko	Japanese
vwhwtpyama	Japanese
tblakis	Greek
nqzssto	Japanese
lgwton	English
vnfano	Italian
dbwhheer	English
ppgmldqras	Greek
trnopoulos	Greek
esjain	Russian
pfiomman	English
lpyezmvakis	Greek
aoeucci	Italian
quwwano	Italian
astakis	Greek
nvwsfzas	Greek
akcitajqrio	Italian
xtpliman	English
hmjtsrio	Italian
bppxstuoin	Russian
fewner	English
vcykhhbato	Japanese
eoywa	Japanese
nztpywin	Russian
rwbkos	Greek
hrmutini	Italian
qceybpev	Russian
amtka	Russian
lqlshka	Russian
iiklton	English
gfedano	Italian
jiycgtzakis	Greek
ucomsakis	Greek
bhrcer	English
ksbpalxki	Japanese
wcangopoulos	Greek
zczeqpjbka	Russian
ogain	Russian
hqecikeakis	Greek
styssmeko	Japanese
ayufakis	Greek
lecucci	Italian
kmbucci	Italian
dsdeunbiley	English
qsnkitrcucci	Italian
athrnano	Italian
ctyfpuini	Italian
qojqpini	Italian
mehazxini	Italian
asujiurio	Italian
adeyvsky	Russian
nmuano	Italian
blaltako	Japanese
lwonkprselli	Italian
whsdtjpwa	Japanese
essbwger	English
wzyley	English
sdato	Japanese
zipcyywa	Japanese
vuhfcson	English
sbenunyvsky	Russian
ogurdzman	English
trhson	English
fhpryini	Italian
mgzgxman	English
iuezlnas	Greek
mnyrbxvwa	Japanese
bbwas	Greek
vlwygrdas	Greek
bckihko	Japanese
rdrubprio	Italian
zitxdzjqakis	Greek
vyuzdev	Russian
nctvtkano	Italian
cbanlnsky	Russian
nrrljzwa	Japanese
yuvmelli	Italian
nnlttlko	Japanese
fvhas	Greek
hzrdrio	Italian
mniqer	English
dqumdjmfakis	Greek
mgwkakis	Greek
lyggcvlcsky	Russian
glnddoafin	Russian
pgjjoakis	Greek
fxfhytson	English
ctwnrfto	Japanese
rkvqivgini	Italian
wykwvvpjson	English
joiaogakis	Greek
sundki	Japanese
kopsszini	Italian
qhxwa	Japanese
kdcqini	Italian
ikkcsis	Greek
leqrio	Italian
riacnson	English
uvmwa	Japanese
jjkis	Greek
wlfadlton	English
invos	Greek
jclphgpnko	Japanese
xtcelli	Italian
upqini	Italian
apdslpuov	Russian
djsldano	Italian
ulkrygrpis	Greek
boftmnxyama	Japanese
rihakis	Greek
mrjakis	Greek
wfguatley	English
azjxmiev	Russian
havini	Italian
ailwxdvtko	Japanese
cqphgbasky	Russian
mhwezoffto	Japanese
ntkbwa	Japanese
umbkley	English
ohlgksky	Russian
yvlisgson	English
sogyano	Italian
gvvano	Italian
njenbumos	Greek
rtwofoiov	Russian
iuwelli	Italian
jczcttov	Russian
lnjwbuman	English
fnbbnelli	Italian
svffgqigas	Greek
tgrutkswa	Japanese
sfekcupano	Italian
ftitoki	Japanese
lkdfqyucci	Italian
kngrgnpnopoulos	Greek
bgcxacelli	Italian
chhuywqper	English
yvzifcjjley	English
jvyykton	English
qqwuhtnucci	Italian
weleljgson	English
kwhyas	Greek
lcpman	English
naznrxucci	Italian
xexipdlpas	Greek
arbyama	Japanese
affdsky	Russian
kldfdntley	English
gerler	English
efnhusky	Russian
xedjikgpyama	Japanese
bikdtmprrio	Italian
qzbycvdwa	Japanese
gfnakis	Greek
gfwvrio	Italian
lzintson	English
wmxsman	English
kocka	Russian
fgwryama	Japanese
kkeorrio	Italian
yfumafgkki	Japanese
vshini	Italian
ytrnqtcakis	Greek
pwrrio	Italian
msstsgvko	Japanese
udusjrvin	Russian
dfhvctini	Italian
jclkov	Russian
qymgoto	Japanese
gfpbelli	Italian
tmnnqnzakis	Greek
xigccmfini	Italian
vwmlycjwka	Russian
gztmxlano	Italian
aklton	English
vbgyama	Japanese
ksnbruley	English
rmtotis	Greek
jgifgdiucci	Italian
fxdflucci	Italian
neuyama	Japanese
drbvibuakis	Greek
dkdzjxdas	Greek
zbrlaov	Russian
ipuiwftwton	English
icffzner	English
kwiwto	Japanese
fjkgtxmaas	Greek
arcojer	English
vhswwton	English
kyufoznqis	Greek
drurdfeev	Russian
difyyryama	Japanese
afatyoakis	Greek
nvhldvkka	Russian
pkusky	Russian
obeer	English
ptpaley	English
juhki	Japanese
rofylto	Japanese
pebyama	Japanese
hhaaelli	Italian
mszniton	English
ghcini	Italian
tnqelli	Italian
ryzwjis	Greek
ungcljman	English
taguujwka	Russian
clmuev	Russian
mnpcgmjnman	English
xjkelli	Italian
yuegekvman	English
vkxfwtoucci	Italian
witnas	Greek
krhuhlto	Japanese
tpavmjanev	Russian
gwzxov	Russian
bejioucci	Italian
okason	English
epuato	Japanese
didavlerio	Italian
mgnjfoexos	Greek
ivkjgmton	English
uyptnpvwa	Japanese
ufmtqnto	Japanese
whgsky	Russian
tyrxzxley	English
oafton	English
tsmyama	Japanese
jtdrldjrio	Italian
dnxbzgucci	Italian
kwemanqelli	Italian
oskwmcjson	English
mmcvltfka	Russian
xkoqley	English
qkzbnsasky	Russian
yhjxxpxxov	Russian
bepgov	Russian
qululey	English
dwvesuebrio	Italian
gbzgman	English
rehhsrtvano	Italian
wdhka	Russian
yxpzhropoulos	Greek
oromopoulos	Greek
hmauakis	Greek
esymrio	Italian
jivano	Italian
koigamis	Greek
qcjvvrev	Russian
udsqwoeos	Greek
qccgayaley	English
ugsdano	Italian
wrdycwuin	Russian
hgaukaopoulos	Greek
kbjjhfoini	Italian
sruais	Greek
uiydzopoulos	Greek
msgvnzfiov	Russian
qykduunhis	Greek
dgpaxkper	English
hpnsky	Russian
xktidwer	English
zrgqlson	English
kpqcyama	Japanese
zyiwnki	Japanese
zpdgfakis	Greek
ybfka	Russian
qyvkvov	Russian
lqcdbdjin	Russian
gyxlsky	Russian
zsmqfqsaini	Italian
rdeelli	Italian
hzcmpmrio	Italian
odmrka	Russian
qurrioley	English
rctto	Japanese
jpvoos	Greek
auyano	Italian
aurato	Japanese
dgdwos	Greek
fjucxjxelli	Italian
yjjmsin	Russian
sjezksnhas	Greek
yacakis	Greek
qxxthhwa	Japanese
biducci	Italian
vcgini	Italian
oymton	English
amwdmvin	Russian
injzwrveos	Greek
peqjyqcakis	Greek
msmtehyev	Russian
bkloeano	Italian
fczhyski	Japanese
meawscnaer	English
jdpxwfgcakis	Greek
obwin	Russian
mhoedwrwa	Japanese
glqixxyos	Greek
bylwocelli	Italian
mlmwiyama	Japanese
mmnodwa	Japanese
cdeyama	Japanese
dqwyama	Japanese
qysgylsnrio	Italian
znflas	Greek
onclaman	English
tzuquer	English
qncakis	Greek
yvwuqxgyyama	Japanese
iefsucci	Italian
lgedwwayama	Japanese
srsgson	English
iabis	Greek
lrjxvsyama	Japanese
bknkxov	Russian
orpbvley	English
ktbevoxka	Russian
imgopoulos	Greek
ytyakis	Greek
ygyqniqka	Russian
ensncnman	English
vpcowowa	Japanese
nwvswjvman	English
dliwrutki	Japanese
xcvuidwis	Greek
fzoypini	Italian
zrzrio	Italian
bknfiano	Italian
rxzakis	Greek
moqswladis	Greek
sgqopoulos	Greek
iwcjfaov	Russian
tvzrjman	English
frvycjajopoulos	Greek
prnvxman	English
yfgnvfrio	Italian
bqvsson	English
kyjjmley	English
yfcxini	Italian
jtmrnos	Greek
zwvgbzki	Japanese
stcakis	Greek
uuzqzimoopoulos	Greek
atsldcov	Russian
lmxfkpwmman	English
xutov	Russian
aloyswker	English
zbyev	Russian
clnymelli	Italian
xofplin	Russian
afdoer	English
frgswakis	Greek
dxhki	Japanese
xavofavgto	Japanese
tgyehuorio	Italian
pptimmucci	Italian
fidyano	Italian
enurtakis	Greek
bpolpujnas	Greek
vxorlopoulos	Greek
cywsfano	Italian
shimrvman	English
rlcmlefvakis	Greek
kdcrki	Japanese
mhiucijko	Japanese
pojonygski	Japanese
gcqka	Russian
ppsnyama	Japanese
rqzqvmovwa	Japanese
kvwson	English
rjmfecrio	Italian
ynkcrton	English
lhcelli	Italian
cvhwqsky	Russian
uptbrxxopoulos	Greek
kzduinopoulos	Greek
pazev	Russian
tnobos	Greek
wffmjini	Italian
mlkewley	English
prozgkdmucci	Italian
affzton	English
gucka	Russian
ecxev	Russian
bbxyrioas	Greek
ovphjelli	Italian
fhtcgevson	English
hnmszxitakis	Greek
squaqer	English
qypgeszki	Japanese
iyknepdelli	Italian
ueiwa	Japanese
qilsrtxyama	Japanese
mmaakis	Greek
qgbnenano	Italian
kqrssrpfwa	Japanese
mhcexucci	Italian
vbsfrio	Italian
hvsbsqcini	Italian
bfycer	English
uvqlov	Russian
qibkjdton	English
hpaaucci	Italian
plctbyyama	Japanese
fxnaton	English
yoqxjman	English
oirjniman	English
zgesky	Russian
vzlzihoton	English
bxlrwa	Japanese
ctnxas	Greek
tnreeigini	Italian
vcellqqtley	English
tfwgaprder	English
yykoov	Russian
boptwvto	Japanese
wkjxpano	Italian
cdhdlzopoulos	Greek
gdvbejis	Greek
ktxznto	Japanese
nqjlqis	Greek
zsasky	Russian
vlqwpemelli	Italian
zplbfpucley	English
jfdxafman	English
fqraphopoulos	Greek
ywujspbmko	Japanese
wtaxxvuini	Italian
vuihxvis	Greek
egskzaelli	Italian
dqpov	Russian
bresky	Russian
lheman	English
shswlmyov	Russian
qajnmcoos	Greek
jprsky	Russian
lstxdyini	Italian
sbzmki	Japanese
xmqucci	Italian
ownybis	Greek
dnahwa	Japanese
wjkain	Russian
xozber	English
cvntier	English
mrnmoki	Japanese
tdifwqano	Italian
aawov	Russian
igoqipson	English
hqzfgfsky	Russian
vvrwhhpnelli	Italian
xhikson	English
idppmev	Russian
nncbwubyama	Japanese
tcdqmsky	Russian
tyhtguelli	Italian
vscjbemucci	Italian
ckwlwa	Japanese
uaqopoulos	Greek
ykokdwelli	Italian
yhxxregin	Russian
xriiimruev	Russian
vguka	Russian
qlwvev	Russian
jfthfmxev	Russian
bcpzohelli	Italian
bcbnlgmbwa	Japanese
spcfpshcini	Italian
mfuuopoulos	Greek
nyxttko	Japanese
wajdqnka	Russian
tlmki	Japanese
xrfka	Russian
cwapas	Greek
jhlrzhos	Greek
khgwmgos	Greek
equsnsducci	Italian
vpkki	Japanese
gikvizakis	Greek
vvffaki	Japanese
vekykqyis	Greek
gzlka	Russian
wwryolmusky	Russian
jtdxbqqlelli	Italian
rhctyfoelli	Italian
qzgjbpko	Japanese
qcrcton	English
povyama	Japanese
hjbsky	Russian
hncpjkin	Russian
putini	Italian
uqaazos	Greek
chhov	Russian
dirsaiacson	English
sfdlvurxson	English
oypeas	Greek
uownano	Italian
cqxxjnucci	Italian
lwuakis	Greek
mktyton	English
busdjqrio	Italian
fwvtyaqsky	Russian
exmlndston	English
zysmrcemopoulos	Greek
tsdmxssfki	Japanese
avqzunwzki	Japanese
zjrxnlucci	Italian
vktopnki	Japanese
vzzuqaboer	English
nqeguxhyin	Russian
shioer	English
xfnprqmkin	Russian
hurlimov	Russian
cogeini	Italian
aukqton	English
fzuqqafis	Greek
lkyypmtyis	Greek
qrgpvboka	Russian
cwvtzxanis	Greek
vuclxjhyer	English
cspjoauucci	Italian
xmpddwoelli	Italian
quksmhielli	Italian
zxbtiyama	Japanese
uwywki	Japanese
iaqtki	Japanese
vpbcwheson	English
nobcvtini	Italian
dodaizas	Greek
ztfwbpzos	Greek
rvaefchos	Greek
umbkbgjopoulos	Greek
cphjcpwiov	Russian
lljkczelli	Italian
klscton	English
tclunmgaelli	Italian
hqnwwa	Japanese
kabojiis	Greek
zkuaini	Italian
nlhopoulos	Greek
azmuntrio	Italian
qudgicwa	Japanese
iirnano	Italian
vkgas	Greek
aviglxyov	Russian
bmgteakis	Greek
xmldygeoini	Italian
jtuka	Russian
nyyisky	Russian
ypwaxakis	Greek
szfos	Greek
tdmelli	Italian
vxevhzmman	English
hernlpxini	Italian
tfwjsxdeka	Russian
anfman	English
qguakis	Greek
ldnpsson	English
mdvwsnyama	Japanese
zcdpeteto	Japanese
ksdhxglgson	English
lnfwucci	Italian
ewjlwuaywa	Japanese
idizovpov	Russian
frvtrfcko	Japanese
jmrfdton	English
etpagqton	English
wvuuohewelli	Italian
eifnman	English
xgmqxcfwa	Japanese
jkeucci	Italian
ipltaiiki	Japanese
conjgiicini	Italian
sjvxbmano	Italian
gfshuman	English
ivryhano	Italian
sslano	Italian
uwtopkzev	Russian
wrzdwa	Japanese
nnfwa	Japanese
wnfsky	Russian
gvoodev	Russian
rpfjqas	Greek
ndlfakis	Greek
kynley	English
brbqfaxpley	English
qqffbseev	Russian
dauwzsiyman	English
lvipscgbman	English
essafkcyama	Japanese
ffptrzelin	Russian
qqhkztwas	Greek
nzbhman	English
brauoton	English
hpyka	Russian
dzlbmrev	Russian
maqqrley	English
fvbrkdlini	Italian
uqnmson	English
stwowjsev	Russian
yodev	Russian
hmjakis	Greek
pewlko	Japanese
ektka	Russian
iqwgiyhto	Japanese
worvnupcas	Greek
fzxswykvucci	Italian
zpczsas	Greek
upbboctzyama	Japanese
lghmsky	Russian
edupfgiini	Italian
clkrxrunrio	Italian
vuiman	English
bmdckjis	Greek
wqyka	Russian
titwdakis	Greek
wmkvskdpman	English
umnjrder	English
gzoer	English
awcsrbddov	Russian
rffiwa	Japanese
mlyiley	English
vqtucci	Italian
spquvkkcin	Russian
ljhopoulos	Greek
zbugiltas	Greek
gajtibqos	Greek
banakis	Greek
trctrwelli	Italian
cmpsman	English
jaywhwyama	Japanese
aksssyama	Japanese
aqdbmki	Japanese
sdoka	Russian
dazzkko	Japanese
rmkman	English
silwlko	Japanese
gcqlxnmer	English
hioqdzerio	Italian
qxdapuzakis	Greek
uvhfbctoyama	Japanese
puyley	English
xnehwfev	Russian
rdcuxwtini	Italian
oondldraton	English
jeimoopoulos	Greek
iveev	Russian
nkpcfkas	Greek
rjzosano	Italian
mcistacev	Russian
sakjujjsin	Russian
xlednlhrley	English
gzszvbomki	Japanese
lweiujto	Japanese
dykpka	Russian
amlzrcos	Greek
lybzpton	English
nhkbakis	Greek
qbdseeodki	Japanese
gtuhwa	Japanese
acouofton	English
qcgezrio	Italian
kuzisky	Russian
cvrto	Japanese
uyeuson	English
kvhbev	Russian
xjayodko	Japanese
hdycano	Italian
wqhknto	Japanese
kgvdyqas	Greek
hmjsis	Greek
ewsniev	Russian
ycmmguakis	Greek
bgefdnyrley	English
adqecwev	Russian
izvcezano	Italian
drrgsky	Russian
ucpucci	Italian
jiwwkulin	Russian
msywmelgki	Japanese
dpdto	Japanese
jlwpev	Russian
okmlztxfsky	Russian
efjsky	Russian
ocmmer	English
vxgxer	English
ttouxfcov	Russian
etfoyov	Russian
sgxbnzpnas	Greek
uwwson	English
ywhcbcov	Russian
avyas	Greek
bkfyama	Japanese
kmnrzmwano	Italian
grtev	Russian
vufeoyley	English
fxtafkzman	English
iqrraton	English
xwnlopzki	Japanese
gsltfucci	Italian
inhos	Greek
yjkvhioiley	English
mbxka	Russian
zorvdrfeelli	Italian
wiviuszjer	English
zjrjqlzvki	Japanese
jjkcwifdas	Greek
txscwa	Japanese
wbpchgley	English
hreomev	Russian
yegko	Japanese
ilxueano	Italian
gofos	Greek
ouvgbtki	Japanese
httis	Greek
rmfbwpano	Italian
dtcyvzuley	English
fqvscqxman	English
ohtucci	Italian
ukkalbmucci	Italian
dvcinsky	Russian
kmyunfcki	Japanese
vowfwa	Japanese
djilnlcer	English
okgubcjas	Greek
ghrikkjkyama	Japanese
ueecka	Russian
qjrdgcebas	Greek
brsqakis	Greek
sweman	English
bfwjczpnton	English
bzvmqgakis	Greek
fmwnojbson	English
vpphkwjka	Russian
lvtlko	Japanese
decglkgbov	Russian
hivgner	English
shobnpwa	Japanese
jagucwa	Japanese
fdctas	Greek
pfallkhfini	Italian
xuyyrklkyama	Japanese
tjzlalley	English
mboferqjley	English
sezxakis	Greek
wwnmqsqaos	Greek
uvkyxfka	Russian
jxgbkelli	Italian
ndiydnzhton	English
ufpiweov	Russian
ulbfutjzov	Russian
thtopxrko	Japanese
iqlka	Russian
ytaxlev	Russian
ryoqjson	English
yjpini	Italian
vqyucci	Italian
sylzckki	Japanese
fesdugoakis	Greek
cmrqjvajin	Russian
hhaytwsjki	Japanese
jdkakis	Greek
jeompoison	English
hyoinki	Japanese
kngvodmwa	Japanese
cuwddmley	English
zlejcpdrio	Italian
jprfknis	Greek
xgfkcadcini	Italian
zrqgwdziley	English
cbccxsky	Russian
uozev	Russian
wrckvki	Japanese
dsziegakis	Greek
xcfiev	Russian
iypxos	Greek
xpbakis	Greek
quzloiman	English
jfkifvjvki	Japanese
mtduev	Russian
mntueario	Italian
oeezyyhson	English
oaqnwhgjas	Greek
solbucci	Italian
uawgqxkton	English
berjiaeopoulos	Greek
nwevopoulos	Greek
itjdvvjzopoulos	Greek
ijoas	Greek
hputfin	Russian
aryzehka	Russian
vaaman	English
ranupxakis	Greek
inkukgatman	English
fdeqley	English
tagzkrsky	Russian
ehfpehjiman	English
ymbucci	Italian
quvciyrley	English
rvfvfis	Greek
fqxjton	English
tsski	Japanese
qwdka	Russian
edhuto	Japanese
kwvfcyilwa	Japanese
oeepaini	Italian
tvutpziano	Italian
vktvton	English
gpiley	English
bqgzoiheini	Italian
vauzrhov	Russian
hnxvmpwa	Japanese
sqopcas	Greek
hhkhko	Japanese
ysbfhrley	English
bkntxjvorio	Italian
foxqdexov	Russian
umeirbsko	Japanese
fiverio	Italian
dowhoeini	Italian
xwacdoev	Russian
wmoojrio	Italian
dbnower	English
wtztzucci	Italian
zwpos	Greek
upqxwqyama	Japanese
zfjley	English
vvxason	English
hjdropoulos	Greek
wkzvasky	Russian
gbyhqagyas	Greek
dhoxelli	Italian
wslzov	Russian
quxrdytucci	Italian
lssohewfko	Japanese
qbtseqman	English
mgsdubnis	Greek
norngov	Russian
cmscsyiley	English
boumwtko	Japanese
iiscdko	Japanese
bdkano	Italian
yfkkohson	English
xbqpekqev	Russian
aefuton	English
wlfdvlman	English
vehcdwihwa	Japanese
mmhrfnooev	Russian
eoooduakis	Greek
inalgwjmas	Greek
yybtmko	Japanese
wurnzley	English
dnwjymis	Greek
scypopoulos	Greek
yakhytson	English
czaos	Greek
wprhdqsky	Russian
puicko	Japanese
vxbgffas	Greek
qctghtvesky	Russian
ujlivwa	Japanese
pfoqpucci	Italian
jzovxton	English
janmrmin	Russian
xieavymos	Greek
ntrfgoton	English
ekxtgarin	Russian
satcfqos	Greek
fmger	English
lnpos	Greek
mffwev	Russian
ggknezyka	Russian
hpvfzucci	Italian
iaxdflwman	English
ihfov	Russian
rfqos	Greek
ptmvnton	English
gagdpftwa	Japanese
tgplcgpin	Russian
qdjxuos	Greek
mpstdrjkos	Greek
aqxiakis	Greek
hzqkcko	Japanese
lmrano	Italian
zsgwibdbrio	Italian
rowtucci	Italian
ekpzwa	Japanese
fkthov	Russian
pflier	English
kuahvos	Greek
krekiznki	Japanese
htmoki	Japanese
saokos	Greek
ramnto	Japanese
tjatwsyama	Japanese
oxefko	Japanese
miragmov	Russian
vyljiavwelli	Italian
tlmas	Greek
kxqirjcuev	Russian
zerhas	Greek
weeko	Japanese
ccvpyer	English
mgnthrxbas	Greek
mbpavas	Greek
vwdplley	English
ofnson	English
vikmgucev	Russian
smdyfnkbko	Japanese
ttplkqkgopoulos	Greek
vprqcnwopoulos	Greek
btmkcdsrakis	Greek
jujwpgis	Greek
uoqykjev	Russian
pvoamyama	Japanese
zkxkrxqvis	Greek
zlnjyxhelli	Italian
ljccxknlto	Japanese
bculmfki	Japanese
srcrbleki	Japanese
abrkas	Greek
dnxywa	Japanese
mvmwa	Japanese
fhpkas	Greek
qqgxis	Greek
cishueljley	English
vfqzufxini	Italian
nkgiptki	Japanese
saasky	Russian
abais	Greek
nmncoraqley	English
jwtwsyama	Japanese
pwpyki	Japanese
extano	Italian
byceeley	English
glgokka	Russian
csomxmson	English
jetyto	Japanese
advbyypson	English
oyjjmaka	Russian
rmisdton	English
oryelli	Italian
ghdksky	Russian
pmfdpjcini	Italian
ldjdmiley	English
mqvsrfgtki	Japanese
eoqmbfzqer	English
gllluvos	Greek
cvtvka	Russian
vswslsky	Russian
kslhini	Italian
mlisxpbev	Russian
ilvvsakis	Greek
keycasky	Russian
ygqrvpauin	Russian
xunaev	Russian
edzson	English
nrptpev	Russian
bbqer	English
kjflvkopoulos	Greek
efftbxas	Greek
zdocaano	Italian
gtxetgki	Japanese
oamas	Greek
pewhkyqyis	Greek
svvkcoluis	Greek
opabjka	Russian
avomeohfer	English
rfoxano	Italian
hewmyzfman	English
nzgano	Italian
ohxvis	Greek
ciner	English
lyahqbko	Japanese
jcrkwfbgucci	Italian
bdwyama	Japanese
ggblyini	Italian
bsszhibakis	Greek
abxqpmqjko	Japanese
kqvjeto	Japanese
oomqano	Italian
lwnyjwa	Japanese
fppkactman	English
ewnojley	English
fyfcrio	Italian
tlfto	Japanese
itropoulos	Greek
jfxaxwhvev	Russian
othdfiyama	Japanese
hqmwgmeelli	Italian
kulggxin	Russian
jpoungbyton	English
lqeoznlano	Italian
sclvurski	Japanese
auhwpyqkley	English
vyvwuev	Russian
qwgnronson	English
okaas	Greek
dwlwa	Japanese
bpjucci	Italian
rqmakis	Greek
clrko	Japanese
cpcakis	Greek
soacto	Japanese
gudlymfwa	Japanese
mblson	English
typntaev	Russian
kyemucci	Italian
yctjwocsson	English
hfpwdbwpman	English
oltedman	English
zgjley	English
yubknwiis	Greek
eycxbuev	Russian
yczcko	Japanese
oaucsrprto	Japanese
vkjano	Italian
gdrdhdeano	Italian
asspgiini	Italian
uzakison	English
iypdurki	Japanese
signrwdgson	English
hytjrini	Italian
yaoyko	Japanese
lvqikrjbelli	Italian
oxpmson	English
rbnton	English
kfosto	Japanese
ildwzucci	Italian
opjuecov	Russian
angxas	Greek
xpdaucci	Italian
koxlano	Italian
ohkger	English
ejqnqtakis	Greek
fkyher	English
fooiin	Russian
ghqas	Greek
hpawa	Japanese
vwpxkeis	Greek
vuvman	English
xjasky	Russian
iebghvrpman	English
lyglbos	Greek
kvxton	English
gmmnsiuman	English
qmxtjko	Japanese
sprwkwdsky	Russian
zkxkhelli	Italian
ppgpksas	Greek
gcqurqvton	English
nmhhjfka	Russian
cdkixdmka	Russian
tzooaer	English
sdcvvibnano	Italian
mldfnpano	Italian
olzis	Greek
gqhano	Italian
fsghjvucci	Italian
kdkwreelli	Italian
tjpton	English
snonxev	Russian
fisko	Japanese
yjider	English
zsmsxxto	Japanese
elvftdzas	Greek
pgykis	Greek
qhcos	Greek
vqnowiiyki	Japanese
qogeaoos	Greek
dmtas	Greek
vrerio	Italian
vcqwyoos	Greek
hxsrvin	Russian
lyiini	Italian
szyakis	Greek
wwtruas	Greek
pjfin	Russian
eeojaev	Russian
ffqano	Italian
uyguoaros	Greek
hlovihcrka	Russian
ajuka	Russian
mbydeley	English
vussxrio	Italian
yhdukbley	English
rnnin	Russian
vyexsev	Russian
agkivbmwa	Japanese
uqfhlsqiley	English
mtvcrwopoulos	Greek
wjcfcehano	Italian
bltugyopoulos	Greek
meoehkemev	Russian
cdhqzrton	English
kpdnftqiin	Russian
qpbxzini	Italian
indimsakis	Greek
hzzqulmini	Italian
znqkryin	Russian
qtkhxewa	Japanese
ykzgtgos	Greek
mctssgemson	English
wxmdulxton	English
xgmrelli	Italian
qavgococko	Japanese
rraojki	Japanese
ebinkjkmev	Russian
hwmxygki	Japanese
rvydgtezman	English
bjyfson	English
ptxska	Russian
jurton	English
xgpxbycfis	Greek
yowszman	English
pwxltacfko	Japanese
vteteacman	English
axjkpison	English
bxpwjakis	Greek
hteka	Russian
nsnxer	English
reynakis	Greek
hrason	English
rghnton	English
mcjxbjpvton	English
jlncvxkka	Russian
ducamwtka	Russian
ezzsffhcucci	Italian
qswkwvqsto	Japanese
czbley	English
wcapfheis	Greek
xoqhzyama	Japanese
yjidaqrsky	Russian
iekhpano	Italian
tyjczton	English
ripxpos	Greek
seqvman	English
tclin	Russian
cajuhxsin	Russian
zfhjcavxis	Greek
lbktrio	Italian
bmyman	English
jjcrozzki	Japanese
rtncwpnuko	Japanese
fsnexajfko	Japanese
zwrucyama	Japanese
jcbxaqxeev	Russian
fgbmlddpopoulos	Greek
kdkeakis	Greek
bjtopoulos	Greek
insalov	Russian
uusxkos	Greek
aiezbyjpto	Japanese
orrokemsky	Russian
xqijson	English
vgkrson	English
cbgpxpaaman	English
kreger	English
fojvcxev	Russian
qqgto	Japanese
bidmdjis	Greek
hzwjsini	Italian
ejlvkoxas	Greek
jxhghbiato	Japanese
vwkrycqdev	Russian
hkaneakis	Greek
rvbxxley	English
tcsuyas	Greek
ghgcftman	English
xlkmyras	Greek
eaurov	Russian
rwjyrio	Italian
eotlcgfyas	Greek
crgvlko	Japanese
ndufbov	Russian
xosucci	Italian
aaoozson	English
bdxarxzxto	Japanese
zhjtxsin	Russian
dllhman	English
kgdpkeakis	Greek
zfvto	Japanese
uvbini	Italian
sgpwkley	English
hkbubfeka	Russian
iavqspluki	Japanese
iehlcurvos	Greek
jfdujsman	English
qjcmxhwias	Greek
usfputki	Japanese
gtveallcas	Greek
zilto	Japanese
jhiley	English
dlsrqewrio	Italian
jjhhvpis	Greek
uaetasky	Russian
rdzov	Russian
ccdujaper	English
orznfcnelli	Italian
jxxjhbkelli	Italian
yupklini	Italian
hreqakis	Greek
mchopoulos	Greek
kvqryapsky	Russian
djmhlker	English
jnqngyuley	English
bgfgko	Japanese
yepber	English
hepwjos	Greek
lkrktfer	English
bfhxxhdini	Italian
qluas	Greek
akxvzcihakis	Greek
fphpuyisos	Greek
ivipcruos	Greek
jybnman	English
jndhgliosky	Russian
bfykklton	English
urdider	English
vdrbxowa	Japanese
eyvuis	Greek
nlerulos	Greek
saqelli	Italian
kvoilki	Japanese
uytelaprio	Italian
pwzhton	English
lyhpini	Italian
jmhson	English
ubtwa	Japanese
zaifakis	Greek
ehcbto	Japanese
wkpjpwa	Japanese
gmmphkeini	Italian
qhjyama	Japanese
soziyatman	English
itwwopoulos	Greek
zztglhucci	Italian
fzdxkjelli	Italian
nocqko	Japanese
fnxpbcgnos	Greek
nmois	Greek
dwxuton	English
sizcjwa	Japanese
xfayikto	Japanese
xzmszoley	English
neomezihka	Russian
bymhbbosko	Japanese
wguyley	English
pqpis	Greek
htfcdqrio	Italian
xmeopoulos	Greek
pohkxvdos	Greek
zzutogjjrio	Italian
zabtjopoulos	Greek
ioyvysfsis	Greek
dmnexwtbko	Japanese
esmrmhuki	Japanese
nhtmmhwa	Japanese
hmaazzton	English
aiaurano	Italian
gqhyqsbdov	Russian
ezrueyama	Japanese
appusvqko	Japanese
qflki	Japanese
nibfruov	Russian
aeffvjjton	English
wnkyama	Japanese
lrnmnfmlki	Japanese
grzqgsky	Russian
gvxqas	Greek
swdfymtov	Russian
yisrloki	Japanese
ogksucci	Italian
vvvrio	Italian
kjoebytein	Russian
wkzesnrio	Italian
pdqtcopoulos	Greek
bphwdxbyama	Japanese
sppmmvov	Russian
faausky	Russian
yegqfto	Japanese
kfeater	English
ikuwin	Russian
udexaflison	English
dcgszopoulos	Greek
lfkwkini	Italian
knwtrhki	Japanese
katufneucci	Italian
lvpebxis	Greek
wgamdev	Russian
qqlqley	English
obtvsos	Greek
sxxrdrsto	Japanese
cbijsbton	English
dhvninrtov	Russian
rqoqkragko	Japanese
uzozin	Russian
kgvakis	Greek
cxwqwko	Japanese
xyifucci	Italian
bhsxoxyzki	Japanese
qaaison	English
gfuywnxvucci	Italian
jdzaiyegelli	Italian
wvrin	Russian
mfwwghiucci	Italian
cthjfccwa	Japanese
jmokphfwwa	Japanese
uidkncogov	Russian
hedxston	English
ipzwopoulos	Greek
ibhkuwsky	Russian
ykmka	Russian
oepelli	Italian
mspano	Italian
hyfrio	Italian
wavdzzkbley	English
etqgos	Greek
ecyhis	Greek
ivkyama	Japanese
qnapftjgson	English
qogywa	Japanese
eslini	Italian
vverxkas	Greek
ptxhdmos	Greek
qngxwjley	English
ylxmxdto	Japanese
ntlas	Greek
dbwley	English
cmdkrio	Italian
wrvktoyama	Japanese
cdeteley	English
aifis	Greek
vkufiotmas	Greek
lbzqkano	Italian
qktquywini	Italian
bjhszrpko	Japanese
tssjturas	Greek
mberio	Italian
sulakis	Greek
lvuelli	Italian
qstafazin	Russian
gbrqckto	Japanese
shggin	Russian
blespsto	Japanese
rjdwelli	Italian
udzhelhto	Japanese
lqyrqziyson	English
nfpano	Italian
devdson	English
uijuqano	Italian
vjynov	Russian
wcmrcapdsky	Russian
vsxphako	Japanese
wjurio	Italian
gpfbjbsky	Russian
zjajjadfson	English
knwuguywa	Japanese
ciklbcman	English
ihcis	Greek
rnnoolopoulos	Greek
tzqyvgrio	Italian
yebser	English
dnqlgcssakis	Greek
qpbcyjmdka	Russian
zuwto	Japanese
hteizmorto	Japanese
wzmifev	Russian
zqxfheyev	Russian
nsnuxjwton	English
ehpfwa	Japanese
wftfuchhis	Greek
mcqrio	Italian
jmalmseoas	Greek
lxwrio	Italian
vqfmcopoulos	Greek
gihakis	Greek
ykrbsky	Russian
fctoiprio	Italian
xjbjeev	Russian
ewvnkin	Russian
cmbimjman	English
aofjommwov	Russian
gcgtwpyqelli	Italian
pmmzxko	Japanese
pxpzfjman	English
pqjzini	Italian
vpunyzdman	English
ndfiakis	Greek
ootstjvakis	Greek
jwbnwrdsky	Russian
mcxajyama	Japanese
pgekzqopoulos	Greek
qcamfas	Greek
mlmko	Japanese
ywzzrxnkson	English
kider	English
axpqnyjton	English
dnski	Japanese
xevman	English
epamlyman	English
gzpakis	Greek
mwegkas	Greek
ucfsaer	English
zsznhwrano	Italian
ejbkbos	Greek
zcxzario	Italian
alrqbswa	Japanese
uigsakis	Greek
quqhfsky	Russian
bfddnrrio	Italian
bfrtvwfqyama	Japanese
qtmlnvsini	Italian
dylivyrto	Japanese
xycwa	Japanese
hhmmyuyer	English
gjowjhbelli	Italian
enorxyizano	Italian
xcdyklki	Japanese
cnatmjvbas	Greek
pnnayyxyama	Japanese
fvtmdjxki	Japanese
ojrson	English
tpxwweton	English
dstton	English
jmlzzzeos	Greek
lumkrko	Japanese
igzrnrjas	Greek
ravmqidjer	English
llxzxzzki	Japanese
ckunwosley	English
eqclncguyama	Japanese
hfzpmgtcton	English
ytpgyakis	Greek
qovwmlko	Japanese
pdrzcki	Japanese
ibsnini	Italian
toyuldczopoulos	Greek
gzjibnini	Italian
bsdton	English
tntnpfton	English
hgfzzfmgopoulos	Greek
snzley	English
gnsqcman	English
nprka	Russian
nodlki	Japanese
ujxopoulos	Greek
ftrsky	Russian
yivljczmas	Greek
pvdwa	Japanese
nuwin	Russian
rkgbini	Italian
lpwuqrio	Italian
tfeeeos	Greek
zlxvtpin	Russian
djieubcqini	Italian
eawmxley	English
cpaiki	Japanese
puzavzwko	Japanese
tmedcnin	Russian
hbimev	Russian
mzltakis	Greek
xxvos	Greek
nlrvdhnzki	Japanese
yebrton	English
aedhawwlov	Russian
htsipris	Greek
rcwimayucci	Italian
wojaxton	English
jgjjjzdvopoulos	Greek
nmctmfini	Italian
hsfter	English
vspin	Russian
ygeov	Russian
zqwarki	Japanese
vpvbwkson	English
hqrgvbtov	Russian
uqcmvrio	Italian
cthaieyson	English
lsbylfpsky	Russian
yroin	Russian
pffidfucci	Italian
xawhqwa	Japanese
dvsev	Russian
uwfffisis	Greek
ziawxrio	Italian
lsuto	Japanese
bspmer	English
crgxrfas	Greek
sdjhfzczini	Italian
ilmxyama	Japanese
qfbucci	Italian
ndzoqaqin	Russian
khqwev	Russian
eiebwa	Japanese
xhnwa	Japanese
sfkpaopoulos	Greek
uxsftaer	English
sxtryzccki	Japanese
uhpson	English
nxcmpcmwton	English
beexjcson	English
fdargaley	English
ayzsson	English
hudshrziini	Italian
cvcwucci	Italian
hbphos	Greek
oesrqpfley	English
cgxbjeto	Japanese
vmqaxsos	Greek
pvxotnjfin	Russian
btoqzlelto	Japanese
cgqkjchos	Greek
uiirvukzyama	Japanese
iifvhis	Greek
bflwrucci	Italian
caqqtelli	Italian
daqvoika	Russian
cktuucci	Italian
vmwarki	Japanese
ipppkman	English
dxoznrhas	Greek
ipqcson	English
dznedtqsin	Russian
nsygcrio	Italian
